岁 寒 三 友 添 新 色	春 风 满 堂 聚 德 光
小 院 四 方 几 度 春 风 几 度 雨	新 房 一 座 半 藏 农 具 半 藏 书
新 居 时 艳 时 居 新	华 堂 聚 宝 乐 世 家
创 业 正 历 改 革 日	迁 居 又 逢 泰 运 时
月 映 丽 厦 吐 瑞 气	满 院 幸 福 同 庆 喜
春 风 堂 上 新 来 燕	香 雨 庭 前 初 种 花
新 宇 喜 迎 四 方 客	两 手 两 肩 建 大 厦
红 日 高 照 新 居 户	喜 花 常 开 幸 福 家
雄 心 开 伟 业	妙 墨 系 春 秋
大 地 文 风 布	长 空 墨 气 存
大 地 山 川 生 笔 底	神 州 伟 业 出 毫 端
风 月 有 情 常 似 旧	丹 青 妙 处 不 可 言
两 只 起 死 回 生 手	一 颗 安 民 济 世 心
妙 曲 吹 开 百 花 艳	英 姿 舞 得 万 马 腾
艺 苑 花 开 添 锦 绣	文 坛 春 暖 布 阳 和
唯 求 利 若 源 头 水	但 得 财 如 锦 上 花
开 张 笑 纳 城 乡 客	开 业 喜 迎 远 近 宾
酒 店 新 开 杨 柳 岸	青 帘 高 挂 杏 黄 旗
看 今 日 吉 祥 开 业	待 明 朝 大 富 启 源
酒 楼 开 业 逢 盛 世	贺 客 盈 门 颂 吉 祥
红 梅 献 瑞 祝 新 店	瑞 雪 拥 祥 贺 启 门
公 平 有 德 财 源 广	和 气 致 祥 生 意 兴
满 面 春 风 开 业 喜	应 时 生 意 在 人 为
生 意 如 春 意	新 行 胜 旧 行
盈 门 飞 酒 韵	开 业 会 春 风
祝 开 门 大 吉 喜 看 四 方 进 宝	贺 同 道 呈 祥 欣 期 八 路 来 财
财 如 晓 日 腾 云 起	利 似 春 潮 带 雨 来
开 张 呈 喜 无 边 春 色 融 融 乐	举 业 有 方 不 尽 财 源 滚 滚 来
顾 客 如 川 川 流 不 息	生 财 有 道 道 畅 无 穷
升 临 福 地	祥 集 德 门
财 源 通 四 海	生 意 畅 三 春
财 源 若 海	顾 客 盈 门
友 以 义 交 情 可 久	财 从 公 取 利 方 长
昌 期 开 景 运	泰 象 启 阳 春
万 民 便 利	百 货 流 通
货 好 门 若 市	心 公 客 常 来
吉 星 欣 在 店	祥 霭 喜 盈 门
事 与 人 便 人 称 便	货 招 客 来 客 自 来
开 业 经 营 门 庭 若 市	热 心 服 务 寒 月 如 春
隆 声 远 布	兴 业 长 新
门 前 大 道 通 八 方 利 路	店 后 小 溪 纳 四 面 财 源
公 平 交 易 财 源 广	合 理 经 营 利 路 长
货 畅 其 流 通 四 海	誉 取 于 信 达 三 江
根 深 叶 茂 无 疆 业	源 远 流 长 有 道 才
文 明 经 商 生 意 好	礼 貌 待 客 顾 客 多
利 泽 源 头 水	生 意 锦 上 花
树 雄 心 创 大 业 江 山 添 锦 绣	立 壮 志 写 春 秋 日 月 耀 光 华
凌 霄 挥 巨 手	立 地 起 高 楼
大 业 开 鹏 举	东 风 启 壮 图
飞 驰 千 里 马	更 上 一 层 楼
无 限 春 光 无 限 路	有 为 时 代 有 为 人
雄 心 创 大 业	壮 志 写 春 秋
一 代 风 流 健 步 腾 飞 奔 四 化	十 层 楼 厦 雄 姿 威 武 奋 千 军
起 程 虽 是 小 天 地	创 业 如 同 大 文 章
开 张 迎 喜 报	举 步 尽 春 光
四 化 腾 飞 天 永 盛	千 军 奋 进 业 方 兴
调 琴 调 新 调 调 调 调 来 调 调 妙	种 花 种 好 种 种 种 种 成 种 种 香
行 行 行 行 行 行 行	长 长 长 长 长 长 长
水 水 山 山 处 处 明 明 秀 秀	晴 晴 雨 雨 时 时 好 好 奇 奇
天 连 碧 树 春 滋 雨	地 满 红 香 花 送 风
船 载 石 头 石 重 船 轻 轻 载 重	尺 量 地 面 地 长 尺 短 短 量 长
上 海 自 来 水 来 自 海 上	山 西 悬 空 寺 空 悬 西 山
分 水 桥 边 分 水 吃 分 分 分 开	看 花 亭 下 看 花 回 看 看 看 到
喜 望 金 菊 放	乐 迎 新 人 来
新 笔 红 叶 句	华 堂 友 琴 章
雪 里 红 梅 放	门 前 新 人 来
雪 飘 双 飞 蝶	灯 映 并 头 梅
遗 风 雄 雀 化	明 月 凤 凰 飞
比 翼 双 飞	冰 心 洁 意
二 南 之 美	凤 凰 来 仪
佳 偶 天 成	建 国 齐 家
龙 凤 呈 祥	龙 腾 凤 翔
鸾 凤 和 鸣	梅 柳 迎 春
美 满 婚 姻	鸟 乐 同 林
蓬 门 始 开	乾 坤 交 泰
情 长 意 重	情 深 似 海
情 同 连 理	情 同 如 水
情 真 意 切	情 重 鸳 鸯
雀 屏 中 目	鹊 桥 欢 渡
诗 题 红 叶	四 喜 同 来
松 柏 常 青	天 作 之 合
西 阁 画 眉	喜 成 连 理
喜 结 秦 晋	喜 气 生 辉
喜 气 盈 门	喜 鹊 登 枝
一 门 同 贺	一 门 余 庆
仪 隆 化 育	宜 室 宜 家
莺 歌 燕 舞	永 结 同 心
鱼 尚 比 目	玉 树 琼 枝
鸳 鸯 比 翼	月 明 金 屋
云 天 比 翼	之 子 于 归
志 同 道 合	忠 诚 友 爱
青 龙 进 海	白 马 出 山
百 业 兴 旺 日	五 谷 丰 登 时
爆 竹 传 笑 语	腊 梅 吐 幽 香
地 暖 花 长 发	村 幽 鸟 任 歌
和 风 吹 绿 柳	时 雨 润 春 苗
红 旗 飘 海 上	渔 歌 庆 丰 年
人 勤 三 春 早	地 肥 五 谷 丰
生 产 随 春 长	幸 福 与 日 增
一 帆 云 作 伴	千 里 月 相 随
鱼 香 飘 万 里	日 影 映 千 帆
渔 歌 随 浪 涌	海 货 与 山 齐
青 山 不 老	碧 水 常 流
庭 荣 松 柏	阶 茂 芝 兰
香 飘 四 季	绿 满 九 洲
丹 桂 香 千 里	松 柏 绿 万 年
红 日 辉 林 海	春 光 焕 鸟 音
匠 心 随 所 种	著 手 便 成 春
柳 笛 穿 林 过	山 歌 带 月 行
竹 影 有 新 意	松 风 含 古 姿
无 物 不 照	有 色 皆 空
松 竹 梅 斗 雪	桃 李 杏 争 春
露 根 固 本	仙 草 延 年
有 药 皆 妙	无 丹 不 灵
独 活 灵 芝 草	当 归 何 首 乌
藏 古 今 学 术	聚 天 地 精 华
图 书 腾 凤 彩	声 价 重 鸡 林
图 书 腾 凤 彩	文 笔 若 龙 翔
翠 枝 云 布	黄 蕊 星 罗
画 为 流 美	书 以 言 情
书 为 心 画	画 乃 意 书
妙 质 因 风 剪	新 裁 对 月 圆
喜 看 龙 腾 春 及 第	笑 观 虎 跃 福 临 门
似 锦 前 程 欣 跃 虎	如 诗 前 程 喜 腾 龙
春 到 华 堂 生 百 福	花 发 吉 宅 纳 千 祥
步 步 登 高 财 源 进	岁 岁 平 安 鸿 运 来
门 迎 百 福 人 财 旺	户 纳 千 祥 合 家 欢
出 门 大 吉 迎 福 到	入 门 大 利 接 财 来
新 春 好 运 人 财 旺	佳 岁 平 安 福 满 堂
万 里 鹏 程 添 锦 绣	千 秋 伟 业 更 辉 煌
春 风 得 意 年 年 好	前 程 似 锦 步 步 高
老 少 平 安 千 秋 乐	家 宅 兴 隆 万 代 昌
门 迎 晓 日 财 源 广	户 纳 春 风 吉 庆 多
时 来 运 转 家 昌 盛	心 想 事 成 业 兴 隆
门 迎 百 喜 福 星 照	户 纳 千 祥 乐 平 安
金 玉 满 堂 人 财 旺	荣 华 富 贵 福 寿 长
前 程 好 比 青 山 秀	后 福 犹 如 绿 水 长
欢 天 喜 地 过 大 年	如 意 吉 祥 迎 新 春
一 帆 风 顺 平 安 宅	万 事 如 意 幸 福 家
开 门 见 喜 财 源 进	举 手 迎 春 瑞 泽 来
新 年 创 业 展 鸿 图	吉 宅 迎 春 增 富 贵
前 程 似 锦 步 步 高	春 风 得 意 年 年 好
红 梅 点 点 绣 千 山	春 雨 丝 丝 润 万 物
吉 星 高 照 全 家 福	鸿 运 当 头 万 事 通
富 贵 吉 祥 年 年 在	如 意 财 源 日 日 来
生 意 兴 隆 年 年 旺	财 源 广 进 天 天 发
风 调 福 地 全 家 福	雨 顺 财 源 广 进 财
全 家 平 字 添 百 福	满 门 和 顺 纳 千 祥
丁 财 两 进 家 兴 旺	富 贵 如 春 福 满 堂
庆 丰 收 全 家 欢 乐	贺 新 春 满 屋 生 辉
一 帆 风 顺 创 大 业	万 事 如 意 展 鸿 图
百 花 迎 春 香 满 地	万 事 如 意 喜 临 门
生 意 兴 隆 如 旭 日	财 源 茂 盛 似 春 潮
四 海 财 源 聚 宝 地	九 洲 鸿 运 进 门 庭
万 事 如 意 满 门 顺	四 季 平 安 全 家 福
迎 新 春 福 旺 财 旺	贺 佳 节 家 兴 人 兴
一 张 笑 脸 带 春 风	十 分 生 意 如 泰 山
贺 新 春 家 兴 业 兴	庆 佳 节 福 旺 财 旺
福 门 鸿 运 连 年 盛	宝 地 财 源 逐 日 增
好 运 长 行 添 百 福	欢 乐 满 堂 庆 平 安
满 堂 欢 乐 迎 富 贵	合 家 团 圆 贺 新 年
一 帆 风 顺 年 年 好	万 事 如 意 岁 岁 发
人 兴 财 旺 鸿 福 到	家 和 事 顺 好 运 来
四 季 平 安 四 季 乐	全 家 幸 福 全 家 欢
祝 四 季 平 安 如 意	贺 百 年 荣 华 富 贵
辞 旧 岁 岁 岁 有 余	迎 新 年 年 年 添 福
红 日 照 财 财 满 门	春 风 送 福 福 到 家
春 临 华 堂 繁 花 艳	福 到 门 庭 喜 气 盈
吉 祥 好 运 家 兴 旺	富 贵 平 安 福 满 堂
春 到 堂 前 添 瑞 气	日 照 庭 院 起 祥 云
家 增 财 富 人 增 寿	春 满 乾 坤 福 满 门
发 大 财 一 帆 风 顺	走 鸿 运 心 想 事 成
雄 心 开 创 千 秋 业	奋 志 兴 家 万 事 成
三 星 在 户 财 源 广	五 福 临 门 家 道 兴
财 进 富 门 千 金 聚	福 泽 宝 地 万 年 盛
庭 前 紫 燕 迎 春 舞	院 内 黄 莺 为 客 歌
物 华 天 宝 民 心 乐	人 杰 地 灵 国 运 昌
春 光 似 锦 年 年 美	岁 月 如 歌 日 日 新
白 雪 红 梅 迎 瑞 日	黄 莺 绿 柳 闹 阳 春
日 照 乾 坤 家 家 暖	春 临 大 地 处 处 欢
好 山 好 水 好 社 会 处 处 风 光 好	新 人 新 事 新 风 尚 行 行 气 象 新
风 吹 田 野 绿	梅 开 小 院 春
龙 去 神 威 在	蛇 来 灵 气 生
诗 吟 大 有 岁	人 颂 小 龙 年
和 顺 门 第 增 百 福	合 家 欢 乐 纳 千 祥
精 耕 细 作 丰 收 岁	勤 俭 持 家 有 余 年
旧 岁 又 添 几 个 喜	新 年 更 上 一 层 楼
迎 新 春 江 山 锦 绣	辞 旧 岁 事 泰 辉 煌
迎 新 春 事 事 如 意	接 鸿 福 步 步 高 升
日 出 江 花 红 胜 火	春 来 江 水 绿 如 蓝
民 安 国 泰 逢 盛 世	风 调 雨 顺 颂 华 年
欢 天 喜 地 度 佳 节	张 灯 结 彩 迎 新 春
一 顺 百 顺 万 事 顺	千 福 万 福 满 堂 福
福 临 新 宅 地	祥 云 浮 紫 阁
花 沐 春 风 招 彩 蝶	柳 摇 残 雪 舞 银 蛇
一 帆 风 顺 全 家 福	万 事 如 意 满 门 祥
春 夏 秋 冬 季 季 呈 祥	四 面 八 方 处 处 得 福
金 龙 披 彩 蛇 披 玉	喜 鹊 报 祥 燕 报 春
国 正 华 年 花 来 香	人 逢 盛 世 福 呈 祥
门 迎 旭 日 财 源 广	户 纳 春 风 祥 福 多
喜 庆 爆 竹 福 呈 祥	吉 祥 梅 花 迎 福 年
蛇 舞 升 平 世	莺 歌 富 贵 春
春 至 百 花 福 满 地	时 来 万 事 祥 临 门
金 龙 闹 海 福 潮 涌	喜 鹊 登 枝 祥 韵 高
花 放 山 河 丽	蛇 迎 世 纪 春
龙 舞 山 河 壮	蛇 盘 世 纪 新
金 蛇 狂 舞 祥 添 彩	玉 树 临 风 福 满 门
福 运 福 多 福 年 会 蛇 年	祥 云 祥 和 祥 月 迎 新 月
金 蛇 含 瑞 草	紫 燕 报 新 春
龙 留 祥 气 福 盈 门 户	蛇 闹 春 光 春 满 山 川
东 成 西 就 全 家 福	南 通 北 达 多 呈 祥
金 蛇 狂 舞 时	紫 燕 报 春 时
千 里 云 霞 辉 大 地	万 般 气 象 福 呈 祥
辞 旧 岁 家 业 兴 旺	迎 新 年 百 福 呈 祥
福 气 呈 祥 舒 万 物	财 源 有 路 富 千 家
福 气 临 门 招 百 福	祥 光 入 户 纳 万 祥
龙 留 喜 气 喜 盈 门 户	蛇 闹 春 光 春 满 山 川
金 蛇 献 瑞 福 呈 祥	绿 柳 迎 春 喜 千 家
丰 年 龙 腾 盈 喜 气	新 岁 蛇 跃 涌 春 潮
辞 旧 岁 喜 看 金 秋 人 人 祥	迎 新 年 欢 庆 蛇 春 家 家 福
国 泰 民 安 满 园 春	家 和 人 寿 福 呈 祥
天 地 无 私 千 里 祥	家 门 有 德 万 年 福
龙 去 神 威 在	蛇 来 紫 气 生
绿 竹 别 其 三 分 景	红 梅 正 报 万 家 春
春 临 大 地 百 花 艳	节 至 人 间 万 象 新
事 事 如 意 大 吉 祥	家 家 顺 心 永 安 康
幸 福 佳 偶 同 心 结	美 满 良 缘 百 年 合
永 成 佳 偶 度 其 昌	天 赋 良 缘 谐 好 合
庆 万 载 幸 福 吉 祥	贺 百 年 姻 缘 和 美
天 喜 地 喜 催 得 红 梅 放	主 欢 宾 欢 迎 将 新 人 来
自 愿 自 由 情 投 意 合	相 亲 相 爱 花 好 月 圆
万 里 长 征 欣 比 翼	百 年 好 合 喜 同 心
红 莺 鸣 绿 树	对 燕 舞 繁 花
红 梅 吐 芳 喜 成 边 理	绿 柳 含 笑 永 结 同 心
连 理 枝 喜 结 大 地	比 翼 鸟 欢 翔 长 天
几 杯 淡 酒 难 称 宴	一 意 留 宾 莫 说 归
碧 岸 雨 收 莺 语 暖	蓝 田 玉 暖 玉 生 香
红 杏 争 春 群 芳 献 瑞	白 华 养 志 二 老 承 欢
大 驾 光 临 门 第 耀	良 辰 聚 会 主 宾 欢
青 梅 酒 熟 凭 君 醉	红 烛 春 浓 任 客 谈
东 风 入 户	喜 气 盈 门
生 意 兴 隆 通 四 海	三 尺 柜 台 传 暖 意
百 货 商 店 店 里 百 货 如 意 店	一 颗 红 心 心 中 一 颗 为 民 心
文 明 经 商 丹 心 似 火 三 冬 暖	礼 貌 待 客 笑 脸 如 春 一 店 香
财 如 晓 日 腾 云 起	一 点 公 心 平 似 水
喜 待 东 西 南 北 客	进 店 来 人 人 满 意
语 似 春 风 吹 暖 四 方 八 面	心 如 炉 火 映 红 万 户 千 家
灵 活 经 营 财 源 茂 盛	春 夏 秋 冬 门 庭 若 市
东 无 西 有 通 无 有	方 与 人 便 人 称 便
精 美 齐 全 销 春 夏 秋 冬 之 货	热 情 周 到 迎 东 西 南 北 之 客
薄 利 多 销 生 意 兴 隆	东 西 南 北 宾 至 如 归
以 天 下 为 己 任 丹 心 似 火	把 顾 客 当 亲 人 笑 脸 如 春
财 源 茂 盛 达 三 江	一 张 笑 脸 带 春 风
有 道 经 营 货 备 五 湖 四 海	周 全 服 务 心 怀 万 户 千 家
门 市 笑 迎 远 近 客	经 商 信 义 坚 如 铁
礼 貌 待 客 品 自 高	好 货 能 招 四 海 宾
庆 新 校 改 颜 国 旗 招 展 腾 腾 气	祝 教 园 更 貌 院 舍 生 辉 振 振 歌
闲 看 门 中 木	思 间 心 上 田
书 生 书 生 问 先 生 先 生 先 生	步 快 步 快 追 马 快 马 快 马 快
白 蛇 过 江 头 顶 一 轮 红 日	青 龙 挂 壁 身 披 万 点 金 星
花 甲 重 开 外 加 三 七 岁 月	古 稀 双 庆 内 多 一 个 春 秋
贤 出 多 福 地	地 福 多 出 贤
道 贯 古 今	七 祖 道 场
不 二 法 门	虎 啸 龙 吟
竹 里 泉 声	利 归 于 民
五 桂 安 居	色 即 是 空
外 海 一 人	一 切 有 情
道 贯 古 今	人 生 于 寅
名 教 万 邦	入 乾 坤 门
人 生 于 寅	入 乾 坤 门
博 采 众 方	天 保 九 如
大 河 前 横	有 仙 则 名
鹤 算 筹 添	甲 第 增 辉
鹤 算 千 年 寿	松 龄 万 古 春
菊 水 人 皆 寿	桃 源 境 是 仙
露 滋 三 秀 草	云 护 九 如 松
上 苑 梅 花 早	仙 阶 柏 叶 荣
河 山 并 寿	日 月 双 辉
家 中 全 福	天 上 双 星
双 寿 共 道	两 星 齐 明
双 星 天 象	全 福 人 家
瑞 霭 全 家 福	光 耀 半 边 天
一 元 复 始	万 象 更 新
人 民 万 岁	祖 国 永 昌
江 山 秀 丽	人 物 风 流
欢 天 喜 地	吐 气 扬 眉
喜 辞 旧 岁	笑 迎 新 春
岁 将 更 始	时 乃 日 新
三 春 过 半	百 刻 平 分
日 已 长 至	夏 正 当 中
月 端 正	秋 平 分
一 阳 初 动 日	六 律 始 调 时
登 台 仁 寿 宇	吹 律 太 平 年
初 行 木 德	始 正 农 祥
三 阳 开 泰	万 物 登 明
满 院 桐 云	北 窗 纳 凉
百 宝 成 船	四 月 为 余
会 集 龙 华	气 尚 清 和
草 霭 繁 霜	南 至 书 云
开 献 节	动 初 阳
三 阳 胜 景	七 日 灵 辰
岁 越 七 日	旧 号 灵 辰
夫 妻 恩 爱	家 庭 祥 和
天 长 地 久	花 好 月 圆
天 成 佳 偶	金 玉 良 缘
投 情 合 意	携 手 同 心
行 文 明 礼	结 自 由 婚
鸳 鸯 对 舞	鸾 凤 和 鸣
百 年 歌 好 合	两 美 结 良 缘
吹 箫 堪 引 凤	攀 桂 喜 乘 龙
革 命 交 知 己	劳 动 结 同 心
红 梅 思 爱 意	绿 竹 贺 新 人
欢 歌 随 凤 舞	笑 语 伴 龙 腾
几 生 修 得 到	一 日 不 可 无
金 风 吹 静 夜	明 月 照 新 房
菊 垂 金 作 客	梅 点 玉 为 容
良 辰 添 吉 庆	嘉 礼 占 文 明
齐 种 爱 情 树	同 当 幸 福 人
三 星 喜 在 户	五 世 歌 好 合
笙 箫 奏 凤 凰	鼓 乐 迎 佳 宾
四 季 花 长 好	百 年 月 永 圆
喜 望 红 梅 放	乐 迎 新 人 来
祥 云 绕 屋 宇	喜 气 盈 门 庭
杨 柳 含 春 意	天 涯 有 知 音
百 年 好 合	五 世 其 昌
蓝 田 种 玉	红 叶 题 诗
鸳 鸯 比 翼	龙 凤 呈 祥
芝 兰 千 茂	鸾 凤 百 鸣
锦 堂 双 壁 合	玉 树 万 枝 荣
蓝 田 曾 种 玉	红 叶 自 吟 诗
双 莺 鸣 翠 树	对 燕 舞 繁 花
鱼 水 千 年 合	芝 兰 百 世 昌
新 事 业 从 头 做 起	旧 现 象 一 手 推 平
顶 上 圆 光 尽 生 美 泽	眉 间 英 气 更 露 清 扬
共 沐 一 池 水	分 享 四 季 春
讲 文 明 莫 忘 清 洁	勤 沐 浴 有 利 健 康
金 鸡 未 唱 汤 先 热	旭 日 初 临 客 早 来
石 池 春 暖 人 宜 浴	水 阁 冬 温 客 更 多
汤 泉 里 有 浮 沉 客	暖 室 中 多 健 康 人
宝 号 芳 名 四 海 播	商 家 顾 客 九 州 来
广 播 银 屏 传 宝 号	乡 村 城 市 播 芳 名
商 品 信 息 四 处 播	财 源 利 润 五 湖 来
通 八 方 信 息	聚 四 海 财 源
信 息 为 财 富	时 间 是 金 钱
智 能 伴 信 息	财 源 托 春 风
收 听 四 海 信 息	聚 积 八 方 财 源
丰 产 多 于 肥 田 里	发 财 全 在 信 息 中
条 条 信 息 为 财 富	刻 刻 时 间 是 金 钱
无 边 信 息 频 频 至	不 尽 财 源 滚 滚 来
无 边 信 息 天 天 至	不 尽 财 源 日 日 来
信 息 灵 通 财 源 广	人 才 开 发 效 益 高
信 息 生 财 财 路 广	科 学 致 富 富 源 宽
金 牛 贺 岁	玉 鼠 回 宫
布 谷 迎 春 叫	牵 牛 接 福 来
草 发 黄 牛 乐	春 新 紫 燕 歌
草 绿 黄 牛 卧	松 青 白 鹤 栖
春 来 紫 燕 舞	节 到 黄 牛 忙
春 丽 牛 逢 草	月 明 马 识 途
春 暖 青 牛 跃	山 高 碧 水 流
催 春 布 谷 叫	报 喜 牵 牛 开
欢 度 新 春 节	高 歌 小 放 牛
黄 牛 耕 碧 野	白 首 乐 红 楼
黄 牛 耕 九 野	白 马 战 疆 场
将 军 爱 战 马	农 夫 喜 黄 牛
金 牛 奔 盛 世	紫 燕 舞 新 春
客 岁 送 金 鼠	今 年 买 铁 牛
牛 耕 芳 草 地	鹊 报 吉 祥 年
牛 耕 千 野 绿	鹊 闹 一 庭 春
牛 舞 丰 收 岁	鸟 鸣 幸 福 春
牵 牛 花 报 喜	布 谷 鸟 催 春
人 逢 如 意 事	牛 舞 艳 阳 春
人 勤 春 来 早	草 发 牛 更 肥
瑞 雪 迎 春 到	金 牛 贺 岁 来
深 恩 红 赤 日	忠 实 老 黄 牛
岁 首 春 到 户	牛 年 福 满 门
紫 燕 寻 旧 主	金 牛 舞 新 春
碧 野 黄 牛 春 日 丽	红 灯 绿 酒 丽 人 年
布 谷 鸟 鸣 忙 布 谷	牵 牛 花 绽 喜 牵 牛
龙 腾 虎 啸	腊 尽 春 回
虎 啸 风 声 远	龙 腾 海 浪 高
龙 引 千 江 水	虎 越 万 重 山
山 月 流 古 雪	风 虎 浴 清 泉
事 事 都 如 意	虎 虎 有 生 气
百 尺 飞 泉 鸣 震 谷	一 声 长 啸 势 惊 天
春 光 春 色 源 春 意	虎 将 虎 年 扬 虎 威
虎 步 奔 腾 开 胜 景	春 风 浩 荡 展 鸿 图
虎 气 频 催 翻 旧 景	春 风 浩 荡 著 新 篇
虎 啸 大 山 山 献 宝	龙 腾 祖 国 国 扬 威
虎 啸 青 山 千 里 锦	风 拂 绿 柳 万 家 春
虎 啸 一 声 山 海 动	龙 腾 三 界 吉 祥 来
虎 跃 龙 腾 生 紫 气	风 调 雨 顺 兆 丰 年
虎 跃 神 州 千 业 旺	春 临 盛 世 万 民 欢
花 事 才 逢 花 好 日	虎 年 更 有 虎 威 风
江 山 秀 丽 春 增 色	事 业 辉 煌 虎 更 威
江 山 一 统 腾 龙 日	岁 月 三 春 入 虎 年
金 牛 辞 岁 寒 风 尽	白 虎 迎 春 喜 气 来
金 牛 送 旧 千 家 乐	玉 虎 迎 新 万 户 欢
龙 腾 虎 跃 人 间 景	鸟 语 花 香 天 地 春
红 梅 香 小 院	玉 兔 下 人 间
红 梅 迎 春 笑	玉 兔 出 月 欢
红 梅 迎 雪 放	玉 兔 踏 春 来
虎 去 威 犹 在	兔 来 运 更 昌
虎 去 雄 风 在	兔 来 喜 气 浓
虎 啸 青 山 秀	兔 奔 碧 野 宽
虎 跃 前 程 去	兔 携 好 运 来
金 鸡 争 唱 晓	玉 兔 喜 迎 春
兔 岁 添 福 气	龙 人 奋 雄 程
玉 兔 迎 春 到	红 梅 祝 福 来
玉 兔 迎 春 至	黄 莺 报 喜 来
春 自 寒 梅 报 起	年 从 玉 兔 迎 来
虎 啸 凯 歌 一 曲	兔 奔 喜 报 九 州
虎 奔 千 里 留 雄 劲	兔 进 万 家 报 吉 祥
虎 年 喜 结 丰 收 果	兔 岁 欣 开 幸 福 花
虎 去 雄 风 惊 五 岳	兔 开 健 步 跃 三 江
虎 岁 扬 威 兴 骏 业	兔 年 献 彩 立 新 功
藏 龙 卧 虎	人 杰 地 灵
龙 腾 翻 巨 浪	虎 啸 动 春 雷
万 众 思 改 革	群 龙 志 腾 飞
燕 语 新 华 喜	龙 腾 大 地 春
龙 飞 蛇 舞	燕 语 莺 歌
百 花 齐 放	万 马 奔 腾
彩 云 追 月	骏 马 迎 春
小 龙 辞 岁	骏 马 迎 春
百 花 开 锦 绣	万 马 起 云 烟
乘 风 腾 骏 马	兴 国 舞 神 龙
春 来 山 水 秀	马 跃 路 途 宽
春 色 绿 千 里	马 蹄 香 万 家
春 新 门 载 福	志 远 马 扬 蹄
丰 年 飞 瑞 雪	骏 马 跃 长 征
风 度 竹 流 韵	马 驰 春 作 声
共 莺 传 捷 报	赤 兔 踏 春 光
海 阔 凭 鱼 跃	路 遥 任 马 驰
花 开 天 下 福	马 跃 人 间 春
花 香 招 鸟 语	马 跃 起 龙 图
骏 马 生 双 翼	鸿 图 壮 九 州
凯 歌 辞 旧 岁	骏 马 迎 新 春
凯 歌 送 旧 岁	骏 马 迎 新 春
柳 绿 春 江 月	旗 红 骏 马 图
马 踏 春 锦 绣	莺 歌 世 风 流
马 腾 风 雪 舞	春 到 杏 花 红
马 腾 改 革 路	国 展 富 强 图
马 啸 关 山 月	莺 歌 杨 柳 春
马 跃 阳 关 道	春 回 杨 柳 枝
人 饮 春 节 酒	马 渡 风 月 关
三 春 播 喜 气	万 马 荡 雄 风
天 高 鹏 展 翼	路 远 马 扬 蹄
万 马 奔 腾 日	九 州 幸 福 春
万 马 奔 腾 日	千 门 幸 福 春
万 马 争 飞 跃	百 花 展 笑 颜
闻 鸡 先 起 舞	跃 马 共 迎 春
燕 莺 新 气 象	龙 马 壮 精 神
扬 鞭 催 骏 马	把 酒 会 春 风
迎 春 燕 语 巧	踏 雪 马 蹄 香
壮 士 喜 骏 马	红 花 爱 英 雄
大 地 生 香 吐 艳	神 州 跃 马 争 春
飞 雪 片 片 凝 瑞	马 蹄 声 声 报 春
留 下 小 龙 胜 景	迎 来 骏 马 新 春
日 丽 风 和 景 艳	人 欢 马 叫 春 新
尚 存 金 蛇 灵 气	重 振 龙 马 精 神
天 马 横 空 出 世	腊 梅 傲 雪 迎 春
雪 瑞 年 丰 福 满	人 欢 马 叫 春 浓
羊 肥 马 壮	国 富 民 丰
羊 迎 大 吉	岁 纳 永 康
春 草 连 天 绿	羊 群 动 地 欢
春 风 追 丽 日	羊 角 步 青 云
春 来 羊 起 舞	雪 化 马 归 山
春 新 羊 得 草	世 盛 马 加 鞭
金 马 辞 旧 岁	银 羊 贺 新 春
骏 马 奔 千 里	吉 羊 进 万 家
骏 马 春 常 在	吉 羊 福 又 添
骏 马 归 山 野	灵 羊 爱 草 原
腊 鼓 催 神 骏	春 风 送 吉 羊
马 驰 金 世 界	羊 唤 玉 乾 坤
马 带 祥 云 去	羊 铺 锦 绣 来
马 留 英 雄 气	羊 会 世 纪 风
马 去 雄 风 在	羊 来 福 气 生
马 跃 庆 丰 年	羊 鸣 歌 盛 世
马 载 祥 云 去	羊 携 惠 雨 来
三 羊 开 景 泰	双 燕 舞 春 风
三 羊 生 瑞 气	百 鸟 唤 春 光
笙 歌 辞 旧 岁	羊 酒 庆 新 春
万 家 腾 笑 语	四 海 庆 阳 春
五 羊 争 献 瑞	万 马 喜 留 春
羊 毫 书 特 色	燕 翼 绣 春 光
马 岁 家 家 如 意	羊 年 事 事 吉 祥
马 啸 英 雄 浩 气	羊 鸣 世 纪 春 光
喜 鹊 登 枝 祝 福	灵 羊 及 地 呈 祥
事 事 顺 心 创 伟 业	年 看 得 意 展 鸿 图
家 居 宝 地 年 年 发	宅 照 福 星 岁 岁 兴
吉 宅 迎 春 增 吉 利	新 年 创 业 展 新 姿
家 和 事 顺 好 运 来	人 兴 财 旺 鸿 福 长
一 帆 风 顺 全 家 福	万 事 如 意 满 堂 春
财 来 运 转 家 昌 盛	心 想 事 成 万 事 兴
求 财 就 手 千 秋 盛	创 业 兴 家 万 代 荣
好 运 当 头 万 事 顺	新 春 及 第 百 花 香
新 春 新 景 新 气 象	多 福 多 财 多 平 安
步 步 登 高 走 鸿 运	岁 岁 平 安 发 大 财
门 盈 喜 气 喜 盈 门	屋 满 春 风 春 满 屋
福 随 瑞 气 来 庭 院	财 伴 春 风 入 宅 门
出 外 顺 景 财 就 手	居 家 欢 乐 事 从 心
一 年 好 运 随 春 到	四 季 财 源 与 日 增
百 业 兴 旺 财 源 广	全 家 和 顺 福 寿 长
喜 居 宝 地 财 兴 旺	福 照 家 门 富 生 辉
万 事 顺 心 成 大 业	春 风 得 意 展 鸿 图
生 意 兴 隆 同 地 久	财 源 广 进 共 天 长
四 海 来 财 生 意 旺	三 江 进 宝 财 源 广
福 满 人 间 家 家 福	春 回 大 地 处 处 春
四 季 平 安 全 家 福	万 事 如 意 满 堂 春
出 门 求 财 添 富 贵	居 家 创 业 得 兴 隆
百 业 农 为 本	万 灵 猴 占 先
跃 虎 争 春 花 满 路	腾 龙 入 世 景 千 重
天 泰 地 泰 三 阳 泰	家 兴 人 兴 天 地 兴
五 福 临 门 千 秋 盛	八 方 进 宝 万 代 昌
金 猴 方 启 岁	绿 柳 又 催 春
迁 新 居 财 源 广 进	创 伟 业 心 想 事 成
门 迎 福 路 发 鸿 福	店 有 财 神 广 进 财
年 年 顺 景 财 源 广	岁 岁 平 安 福 寿 长
吉 星 永 照 平 安 宅	五 福 常 临 积 善 家
门 迎 百 福 福 星 照	户 纳 千 祥 祥 云 腾
佳 岁 平 安 百 业 兴	新 春 大 吉 万 事 成
申 年 梅 献 瑞	猴 岁 雪 兆 丰
腊 梅 吐 芳 迎 红 日	绿 柳 展 枝 舞 春 风
春 随 好 运 千 祥 至	马 到 成 功 万 事 兴
羊 舞 丰 收 岁	猴 吟 锦 绣 春
和 气 生 财 长 富 贵	合 家 欢 乐 永 平 安
丹 凤 呈 祥 凤 献 瑞	红 桃 贺 岁 杏 迎 春
新 春 新 景 新 家 运	多 福 多 财 多 平 安
遍 地 祥 光 临 福 宅	满 天 喜 气 入 华 堂
展 鸿 图 得 心 应 手	创 大 业 马 到 成 功
一 门 福 气 随 心 至	千 里 春 风 顺 意 来
居 家 景 致 常 年 好	创 业 前 程 大 路 通
泰 运 鸿 开 兴 隆 宅	财 源 广 进 昌 盛 家
奔 前 程 一 帆 风 顺	创 大 业 万 里 生 辉
人 兴 财 旺 鸿 福 长	家 和 事 顺 好 运 来
龙 腾 虎 跃 迎 新 岁	国 富 民 强 乐 小 康
万 里 鹏 程 随 心 起	新 年 鸿 运 顺 意 来
鸿 图 大 展 生 意 旺	伟 业 腾 飞 财 源 广
新 春 福 旺 财 宝 聚	佳 节 吉 祥 富 贵 来
福 气 降 临 全 家 福	春 光 辉 映 满 堂 春
新 春 大 吉 行 鸿 运	佳 岁 平 安 照 福 星
春 回 大 地 人 增 寿	福 到 人 间 门 生 辉
新 春 临 宅 家 兴 旺	鸿 福 满 堂 业 顺 利
人 寿 年 丰 歌 盛 世	山 欢 水 笑 庆 新 春
万 众 欢 腾 歌 盛 世	百 花 竞 放 贺 新 春
好 年 好 景 好 运 气	大 吉 大 利 大 发 财
丹 凤 来 仪	金 鸡 报 晓
猴 岁 呈 祥	鸡 年 纳 福
莺 歌 燕 舞 迎 新 纪	虎 跃 龙 腾 奔 锦 程
新 年 顺 景 开 鸿 运	佳 岁 平 安 发 大 财
鹊 送 喜 报	鸡 传 佳 音
喜 迎 福 星 家 兴 旺	乐 接 财 神 人 安 康
神 猴 辞 岁	金 凤 迎 春
展 鸿 图 方 方 顺 利	创 大 业 事 事 成 功
雄 鸡 唱 韵	大 地 回 春
鸡 鸣 天 放 晓	政 改 地 回 春
鸡 声 窗 前 月	人 笑 福 里 春
门 迎 百 福 丁 财 旺	户 纳 千 祥 合 家 欢
万 事 如 意 满 门 财	四 季 平 安 全 家 欢
门 迎 富 贵 平 安 福	家 过 祥 和 健 康 年
金 鸡 日 独 立	紫 燕 春 双 飞
门 前 接 福 福 星 照	店 内 招 财 财 运 来
把 酒 当 歌 歌 盛 世	闻 鸡 起 舞 舞 新 春
鱼 跃 龙 川 承 盛 世	燕 栖 农 家 报 新 春
迎 新 春 事 事 如 意	接 鸿 福 步 步 登 高
新 年 天 意 同 人 意	喜 事 今 春 同 旧 春
国 家 安 定 人 民 乐	党 政 清 廉 事 业 兴
猴 奋 已 教 千 户 乐	鸡 鸣 又 报 万 家 春
鸡 报 小 康 随 日 出	年 迎 大 有 伴 春 来
百 花 迎 春 福 满 庭	万 事 胜 意 喜 临 门
诚 信 经 营 多 得 利	公 平 交 易 可 生 财
商 通 四 海 生 意 旺	富 达 九 洲 财 源 广
年 年 顺 景 开 鸿 运	岁 岁 平 安 发 大 财
春 回 大 地 风 光 好	喜 庆 新 年 事 业 兴
万 里 鹏 程 平 地 起	四 时 鸿 运 顺 意 来
金 鸡 报 晓 歌 大 治	丹 凤 朝 阳 赞 中 兴
金 鸡 高 唱 迎 春 曲	铁 牛 欢 催 改 革 潮
金 鸡 唤 出 扶 桑 日	锦 犬 迎 来 大 地 春
家 庭 顺 景 人 财 旺	宅 宇 兴 隆 老 少 安
春 回 大 地 花 满 路	福 到 人 间 喜 盈 门
生 意 兴 隆 增 百 福	财 源 广 进 纳 千 祥
吉 祥 如 意 福 满 庭	富 贵 平 安 喜 临 门
金 鸡 一 唱 传 佳 讯	玉 犬 三 呼 报 福 音
好 运 迎 进 八 方 宝	新 春 送 来 四 季 福
平 安 富 贵 财 源 进	发 达 荣 华 事 业 兴
人 寿 年 丰 全 家 福	家 兴 业 旺 满 堂 春
两 岸 金 鸡 歌 一 统	九 州 赤 子 报 三 春
门 迎 晓 日 财 源 广	店 纳 春 风 生 意 兴
客 似 云 来 生 意 旺	货 如 轮 转 财 源 广
张 灯 结 彩 迎 新 岁	欢 天 喜 地 庆 佳 节
鸟 报 晴 和 花 报 喜	鸡 生 元 宝 地 生 财
人 财 两 旺 平 安 宅	福 寿 双 全 富 贵 家
万 户 桃 符 新 气 象	群 山 霞 彩 富 神 州
家 添 财 富 人 添 寿	春 满 田 园 福 满 门
家 业 兴 旺 财 源 广	老 少 平 安 福 寿 长
喜 爆 千 声 歌 盛 世	金 鸡 三 遍 报 新 春
瑞 雪 迎 春 门 载 福	梅 花 贺 岁 户 呈 祥
平 安 即 是 全 家 福	和 气 可 生 四 季 财
春 回 大 地 千 山 秀	日 暖 神 州 万 物 荣
喜 鹊 登 枝 迎 新 岁	金 鸡 起 舞 报 福 音
幸 福 花 开 迎 百 福	吉 祥 鸟 唱 报 千 祥
红 灯 喜 接 全 家 福	爆 竹 笑 迎 四 季 春
万 事 如 意 家 业 兴	一 帆 风 顺 财 源 广
华 夏 年 年 开 骏 业	新 春 业 业 展 鸿 图
福 星 永 照 平 安 宅	好 景 常 临 康 乐 家
福 临 宝 地 千 秋 盛	财 进 家 门 万 事 兴
雄 鸡 喜 报 春 光 好	健 笔 勤 书 正 气 多
迎 新 春 八 方 进 宝	逢 盛 世 四 季 招 财
新 春 大 吉 迎 大 利	接 福 添 喜 又 添 财
雄 鸡 喜 唱 升 平 日	志 士 欢 歌 改 革 年
全 家 平 安 添 百 福	满 门 和 顺 纳 千 祥
跃 马 扬 鞭 芳 草 地	闻 鸡 起 舞 杏 花 天
锦 上 添 花 花 似 锦	新 春 报 喜 喜 迎 春
求 财 顺 景 方 方 利	出 入 平 安 事 事 成
腊 梅 报 喜 天 天 喜	瑞 雪 迎 春 处 处 春
高 山 青 松 听 春 鸟	大 地 白 雪 看 红 梅
科 学 发 展 穷 变 富	诚 实 劳 动 土 成 金
祥 光 万 道 临 福 地	瑞 气 千 条 绕 华 庭
新 月 楼 台 竹 影 动	春 风 庭 院 梅 香 飘
锦 上 添 花 花 似 锦	诗 中 有 画 画 如 诗
桃 吐 三 春 迎 富 至	梅 开 五 福 送 财 临
爆 竹 传 吉 语	腊 梅 报 新 春
春 满 人 间 欢 歌 阵 阵	福 临 门 第 喜 气 洋 洋
金 鸡 歌 国 泰	义 犬 报 民 安
金 鸡 交 好 卷	黄 犬 送 佳 音
犬 守 平 安 日	梅 开 如 意 春
祥 随 春 到 祥 天 下	福 同 岁 至 满 人 间
德 门 福 呈 祥	仁 里 龙 飞 腾
龙 怀 强 国 志	蛇 舞 富 春 图
民 逢 大 有 岁	国 正 小 龙 年
巳 岁 迎 祥 花 开 早	蛇 年 纳 福 喜 报 多
龙 去 神 威 在	蛇 来 春 意 浓
龙 去 雄 风 在 江 山 不 老	蛇 来 灵 气 生 岁 月 常 新
岁 岁 年 丰 福 呈 祥	家 家 幸 喜 庆 团 圆
爆 竹 欣 祝 福	银 蛇 乐 报 春
金 山 漫 水 双 蛇 舞	绿 野 春 归 百 鸟 鸣
喜 临 玉 宇 新 春 艳	福 到 门 庭 祥 气 盈
龙 蛇 交 替 舞	岁 月 又 更 新
人 喜 盛 世	鼠 兆 丰 年
蛇 舞 升 福 祥	莺 歌 富 贵 春
百 年 推 甲 子	福 地 在 春 申
喜 气 闹 新 年 千 家 报 喜	春 风 暖 蛇 岁 万 户 迎 春
龙 蛇 交 替 舞	岁 月 福 呈 祥
龙 展 强 邦 志	蛇 生 富 国 情
苍 松 随 岁 古	子 鼠 与 年 新
春 潮 传 喜 讯	鼠 岁 报 佳 音
龙 去 蛇 来 星 移 物 换	莺 飞 燕 舞 日 暖 风 和
庭 前 喜 庆 福 呈 祥	座 上 嘉 宾 对 酒 歌
爆 竹 声 声 福 来 到	祥 和 处 处 岁 时 新
鹊 语 红 梅 放	鼠 年 喜 气 浓
人 欢 为 体 健	鼠 硕 因 年 丰
三 祥 日 照 平 安 宅	五 福 星 临 吉 庆 门
佳 节 舞 龙 蛇 千 家 致 富	东 风 荣 草 木 万 户 迎 春
鼠 至 调 新 律	鸡 鸣 早 报 春
福 祥 福 寿 福 气 满 堂	喜 运 喜 事 喜 气 洋 洋
子 年 春 到 户	鼠 岁 喜 临 门
子 时 春 意 闹	鼠 岁 笑 声 甜
子 时 岁 交 替	鼠 节 春 更 新
子 夜 松 涛 劲	鼠 年 鹊 语 香
诗 吟 大 福 祥	人 颂 小 龙 年
子 夜 岁 交 替	鼠 年 春 更 新
龙 含 宝 珠 辞 旧 岁	蛇 吐 福 祥 贺 新 春
龙 吟 山 海 壮	蛇 舞 国 民 欢
福 日 福 风 福 浩 荡	祥 年 祥 岁 祥 腾 飞
门 迎 春 夏 秋 冬 福	户 纳 东 西 南 北 祥
春 归 大 地 人 间 暖	福 降 神 州 喜 临 门
一 年 好 运 随 春 到	四 季 彩 云 滚 滚 来
春 风 入 喜 财 入 户	岁 月 更 新 福 满 门
盛 世 千 家 乐	新 春 百 家 兴
壮 丽 山 河 多 异 彩	文 明 国 度 遍 高 风
一 年 四 季 春 常 在	万 紫 千 红 永 开 花
大 顺 大 财 大 吉 利	新 春 新 喜 新 世 纪
百 年 天 地 回 元 气	一 统 山 河 际 太 平
占 天 时 地 利 人 和	取 九 州 四 海 财 宝
春 花 含 笑 意	爆 竹 增 欢 声
天 地 和 顺 家 添 财	平 安 如 意 人 多 福
欢 声 笑 语 贺 新 春	欢 聚 一 堂 迎 新 年
喜 居 宝 地 千 年 旺	福 照 家 门 万 事 兴
年 年 顺 景 则 源 广	岁 岁 平 安 福 寿 多
东 风 化 雨 山 山 翠	政 策 归 心 处 处 春
多 劳 多 得 人 人 乐	丰 产 丰 收 岁 岁 甜
家 过 小 康 欢 乐 日	春 回 大 地 艳 阳 天
五 湖 四 海 皆 春 色	万 水 千 山 尽 得 辉
内 外 平 安 好 运 来	合 家 欢 乐 财 源 进
千 年 迎 新 春	瑞 雪 兆 丰 年
高 居 宝 地 财 兴 旺	福 照 家 门 富 生 辉
丹 凤 呈 祥 龙 献 瑞	红 桃 贺 岁 杏 迎 春
福 旺 财 旺 运 气 旺	家 兴 人 兴 事 业 兴
大 地 流 金 万 事 通	冬 去 春 来 万 象 新
一 帆 风 顺 吉 星 到	万 事 如 意 福 临 门
百 世 岁 月 当 代 好	千 古 江 山 今 朝 新
春 满 人 间 百 花 吐 艳	福 临 小 院 四 季 常 安
共 享 锦 绣 年 华	相 伴 健 康 天 使
大 地 歌 唤 彩 云	满 园 春 关 不 住
春 雨 丝 丝 润 万 物	红 梅 点 点 绣 千 山
天 增 岁 月 人 增 寿	春 满 乾 坤 福 满 楼
迎 喜 迎 春 迎 富 贵	接 财 接 福 接 平 安
一 帆 风 顺 年 年 好	万 事 如 意 步 步 高
喜 滋 滋 迎 新 年	笑 盈 盈 辞 旧 岁
财 源 滚 滚 随 春 到	喜 气 洋 洋 伴 福 来
福 星 高 照 全 家 福	春 光 耀 辉 满 堂 春
五 更 分 两 年 年 年 称 心	一 夜 连 两 岁 岁 岁 如 意
黄 莺 鸣 翠 柳	紫 燕 剪 春 风
一 年 四 季 行 好 运	八 方 财 宝 进 家 门
傲 骨 高 风 亮 节	红 梅 翠 竹 青 松
白 雪 红 梅 报 喜	黄 莺 紫 燕 迎 春
一 世 良 缘 同 地 久	百 年 佳 偶 共 天 长
百 花 生 香 吐 艳	四 化 跃 马 扬 鞭
百 花 生 香 吐 艳	四 化 跃 马 争 春
百 花 迎 春 斗 艳	群 英 为 国 争 光
头 上 青 霄 鸾 比 翼	门 中 珠 履 客 谈 心
百 联 同 歌 盛 世	九 州 共 祝 民 康
百 族 家 家 乐 业	九 州 户 户 安 居
爆 竹 声 声 除 旧	桃 符 代 代 更 新
爆 竹 一 声 除 旧	桃 符 万 户 更 新
爆 竹 一 声 除 旧	春 联 万 户 更 新
爆 竹 一 声 辞 旧	桃 符 万 户 更 新
碧 海 苍 山 玉 宇	春 风 丽 日 神 州
碧 岸 雨 收 莺 语 暖	蓝 田 日 暖 玉 生 香
彩 笔 精 描 四 化	红 心 巧 绣 三 春
除 旧 岁 破 旧 俗	迎 新 年 树 新 风
处 处 春 光 济 美	年 年 人 物 风 流
处 处 欢 歌 遍 地	家 家 喜 笑 连 天
处 处 明 山 秀 水	家 家 笑 语 欢 歌
创 造 万 千 气 象	建 设 两 个 文 明
春 草 满 庭 吐 秀	百 花 遍 地 飘 香
春 到 碧 桃 树 上	莺 歌 绿 柳 楼 前
同 心 同 德 美 满 夫 妻	克 勤 克 俭 幸 福 鸳 鸯
春 暖 花 朝 彩 鸾 对 舞	风 和 丽 月 红 杏 添 妆
方 借 花 容 添 月 色	欣 逢 秋 夜 作 春 宵
生 意 通 东 西 财 源 贯 南 北 经 营 有 道	新 风 送 冬 夏 信 誉 奉 春 秋 盈 得 多 方
卧 室 客 室 都 增 辉	上 固 下 坚 俱 暖 心
里 有 仁 风 春 意 永	家 余 德 泽 福 运 长
院 内 红 梅 戏 飞 雪	门 前 翠 柳 舞 春 风
喜 延 明 月 长 登 户	自 有 春 风 奉 扫 门
门 对 青 山 千 古 看	家 居 旺 地 四 时 新
今 冬 如 春 江 山 吐 秀	生 财 有 道 栋 宇 增 辉
华 堂 锦 乡 江 山 添 异 彩	甲 第 祥 和 农 户 乐 重 光
向 阳 庭 院 风 光 好	勤 劳 人 家 幸 福 多
门 对 青 山 庭 铺 瑞 雪	屋 临 绿 水 窗 横 腊 梅
地 久 天 长 门 有 喜	年 丰 人 寿 福 无 边
画 栋 连 云 光 旧 业	华 堂 映 日 耀 新 居
新 屋 落 成 逢 新 岁	春 风 送 暖 发 春 华
门 前 绿 水 声 声 笑	屋 后 青 山 步 步 春
旭 日 随 心 临 吉 宅	春 风 着 意 入 新 居
春 风 杨 柳 鸣 金 屋	晴 雪 梅 花 照 玉 堂
日 丽 风 和 锦 铺 院	冬 暖 夏 爽 笑 满 堂
民 重 农 桑 能 富 国	光 增 新 第 喜 齐 家
三 阳 日 照 平 安 宅	五 福 星 临 吉 庆 门
近 水 楼 台 先 得 月	向 阳 花 木 早 逢 春
一 乡 称 长 者	七 十 日 古 稀
莫 道 人 生 无 百 岁	须 知 草 木 有 重 春
天 边 已 满 一 轮 月	世 上 同 钟 百 岁 人
盛 世 常 青 树	百 年 不 老 松
瑶 池 喜 晋 千 年 酒	海 屋 欣 添 百 岁 筹
琼 材 歌 舞 群 仙 会	海 屋 衣 冠 百 寿 图
百 岁 为 上 寿	一 言 乃 千 金
三 千 美 景 添 筹 算	九 十 风 光 乐 有 余
瑶 池 草 熟 三 千 岁	海 屋 筹 添 九 十 春
歌 人 生 三 乐	颂 天 保 九 如
乐 享 晚 年 漫 道 世 间 难 逢 百 岁	宜 登 上 寿 且 看 堂 上 再 过 十 年
花 甲 虽 周 犹 可 大 显 身 手	精 神 尚 旺 定 能 再 先 扬 鞭
日 月 双 辉 惟 仁 者 寿	阴 阳 合 德 真 古 来 稀
菊 水 不 皆 寿	桃 源 境 是 仙
名 高 北 半	寿 比 南 山
人 歌 上 寿	天 与 稀 龄
四 化 行 春 新 岁 月	九 旬 益 健 老 青 年
人 生 不 满 公 今 满	世 上 难 逢 我 正 逢
现 在 未 必	而 今 不 然
小 坐 片 刻 便 会 放 松 意 念	清 闲 一 会 即 成 造 化 神 仙
说 你 行 你 就 行 不 行 也 得 行	你 说 不 行 就 不 行 行 也 不 行
说 你 行 你 就 行 不 行 也 行	你 说 行 也 不 行 行 也 不 行
天 增 岁 月 人 增 肥	春 满 乾 坤 猪 满 门
好 说 难 说 好 难 说	思 你 念 你 思 念 你
去 除 数 字 一 和 二	还 有 四 五 六 七 九
好 读 书 不 好 读 书	好 读 书 不 好 读 书
畅 通 上 下	雅 集 东 西
日 进 去 笔 水 下 流	浪 起 来 两 脚 朝 天
天 价 中 石 化	大 吃 红 十 字
烟 花 三 月 下 扬 州	春 暖 花 开 游 丽 江
山 东 落 花 生 花 落 东 山	山 西 悬 空 寺 空 悬 西 山
处 处 飞 花 飞 处 处	声 声 笑 语 笑 声 声
山 东 落 花 生 花 落 东 山	湖 南 过 路 车 路 过 南 湖
春 读 书 秋 读 书 春 秋 读 书 读 春 秋	男 学 生 女 学 生 男 女 学 生 生 男 女
上 海 自 来 水 来 自 海 上	黄 山 落 叶 松 叶 落 山 黄
东 当 铺 西 当 铺 东 西 当 铺 当 东 西	南 通 州 北 通 州 南 北 通 州 通 南 北
处 处 红 花 红 处 处	重 重 绿 树 绿 重 重
清 风 满 地 难 容 我	明 月 何 时 再 照 人
读 书 好 耕 田 好 学 好 便 好	创 业 难 守 业 难 知 难 不 难
未 出 土 时 便 有 节	及 凌 云 处 尚 虚 心
绿 绿 红 红 处 处 莺 莺 燕 燕	花 花 草 草 年 年 暮 暮 朝 朝
风 送 花 香 红 满 地	地 满 红 香 花 送 风
春 回 先 富 村	村 富 先 回 春
松 叶 竹 叶 叶 叶 翠	秋 声 雁 声 声 声 寒
艳 艳 红 花 随 落 雨	雨 落 随 花 红 艳 艳
雨 滋 春 树 碧 连 天	天 连 碧 树 春 滋 雨
天 上 月 圆 人 间 月 半 月 月 月 圆 逢 月 半	今 年 年 底 明 年 年 初 年 年 年 底 接 年 初
暮 天 遥 对 寒 窗 雾	雾 窗 寒 对 遥 天 暮
秀 山 轻 雨 青 山 秀	香 柏 鼓 风 鼓 柏 香
有 三 分 水 二 分 竹 添 一 分 明 月	从 五 步 楼 十 步 阁 望 百 步 大 江
香 山 碧 云 寺 云 碧 山 香	黄 山 落 叶 松 叶 落 山 黄
一 夜 五 更 半 夜 五 更 之 半	三 秋 八 月 中 秋 八 月 之 中
千 江 有 水 千 江 月	万 里 无 云 万 里 天
地 得 清 秋 一 半 好	窗 含 明 月 十 分 圆
楼 高 但 任 云 飞 过	池 小 能 将 月 送 来
南 通 州 北 通 州 南 北 通 州 通 南 北	春 读 书 秋 读 书 春 秋 读 书 读 春 秋
望 天 空 空 望 天 天 天 有 空 望 空 天	求 人 难 难 求 人 人 人 逢 难 求 人 难
风 竹 绿 竹 风 翻 绿 竹 竹 翻 风	雪 里 白 梅 雪 映 白 梅 梅 映 雪
南 通 州 北 通 州 南 北 通 州 通 南 北	东 当 铺 西 当 铺 东 西 当 铺 当 东 西
人 过 大 佛 寺	寺 佛 大 过 人
一 肩 风 雪 三 千 里	两 眼 乾 坤 十 二 时
人 中 柳 如 是	是 如 柳 中 人
重 重 绿 树 绿 重 重	声 声 笑 语 笑 声 声
风 送 花 香 红 满 地	雨 滋 春 树 碧 连 天
水 底 月 如 天 上 月	眼 中 人 是 面 前 人
数 年 风 雨 发 花 盛	几 载 炎 凉 举 业 新
携 手 开 华 夏 千 秋 大 业	并 肩 展 神 州 万 古 雄 才
树 雄 心 创 大 业 与 江 山 共 秀	立 壮 志 写 春 秋 共 日 月 同 辉
情 智 育 桃 李	书 香 满 校 园
校 园 迎 春 绿	桃 李 向 阳 红
五 十 春 秋 育 桃 李	一 代 栋 梁 花 满 园
春 风 化 雨 满 园 桃 李 秀	热 心 育 苗 遍 地 栋 梁 材
万 木 参 天 凭 雨 露	千 秋 伟 业 靠 人 才
杏 坛 桃 李 年 年 艳	国 厦 栋 梁 节 节 高
立 德 树 人 桃 李 满 天 下	继 往 开 来 师 道 化 万 方
万 紫 千 红 秋 色 好	五 湖 四 海 栋 梁 多
重 言 教 重 身 教 严 以 律 己	学 知 识 学 品 德 宽 以 待 人
园 丁 辛 苦 一 堂 秀	桃 李 成 材 四 海 春
教 坛 千 古 业	桃 李 一 园 春
花 枝 竞 秀 须 雨 露	桃 李 争 荣 靠 园 丁
金 风 送 爽 颂 盛 世	丹 桂 飘 香 迎 佳 宾
园 中 桃 李 年 年 艳	国 厦 栋 梁 节 节 高
春 色 常 昭 志 士	才 华 乐 奉 勤 人
大 本 领 人 平 素 不 独 特 异 处	有 学 识 者 终 生 难 有 满 足 时
一 年 之 计 春 为 早	千 里 征 程 志 在 先
兴 华 时 有 凌 云 志	报 国 常 怀 赤 子 心
长 江 后 浪 推 前 浪	盛 世 前 贤 让 后 贤
声 声 颂 誉 催 人 奋	朵 朵 红 花 向 党 红
巨 手 回 天 四 化 业	群 英 向 党 百 花 红
改 革 涌 新 潮 群 龙 戏 水	振 兴 挥 壮 志 大 浪 催 舟
第 一 洞 天 无 双 福 地	飞 流 千 尺 明 月 三 湖
善 为 至 宝 一 生 用 之 不 尽	心 作 良 田 百 世 耕 之 有 余
一 切 作 如 是 观 有 即 非 有	众 人 皆 大 欢 喜 闻 所 未 闻
爱 国 爱 民 玉 树 芝 兰 佳 子 弟	春 风 春 雨 朱 楼 画 栋 好 家 居
从 五 步 楼 十 步 阁 望 百 步 大 江	有 三 分 水 四 分 竹 添 七 分 明 月
龙 藏 流 水 井	绿 树 多 生 意
不 要 钱 原 非 异 事	太 要 好 亦 是 私 心
念 苍 赤 何 依 顾 我 犹 存 莫 酬 初 志	求 自 在 不 自 在 知 自 在 自 然 自 在
不 于 其 中 起 分 别	是 故 此 处 最 吉 祥
时 逢 佳 客 开 青 眼	难 得 闲 人 话 白 云
留 此 湖 山 得 此 佳 趣	茂 对 珠 宫 西 来 东 土
道 是 当 年 旧 明 月	好 将 胜 地 记 湖 山
红 雨 一 春 帘 外 水	青 山 六 代 画 中 诗
一 弹 流 水 一 弹 月	半 入 江 风 半 入 云
秋 水 碧 无 际	夕 阳 红 半 城
有 本 者 如 是	有 鹤 松 皆 直
常 将 池 水 映 天 地	不 以 消 长 随 春 秋
宫 中 下 见 南 山 尽	城 上 平 临 北 斗 悬
贵 才 贵 德 贵 诚 信	和 仁 和 智 和 乾 坤
结 泉 阁 今 园 作 环	衔 湖 山 古 井 为 中
三 径 绿 树 人 醉 竹	百 花 红 处 客 寻 春
烟 水 此 间 真 酒 地	风 光 今 日 是 诗 天
舟 行 著 色 屏 风 里	人 在 回 文 锦 字 中
同 是 南 人 四 座 高 风 倾 北 海	来 游 东 国 两 乡 旧 雨 疾 西 湖
万 里 黄 河 流 日 夜	一 池 春 夏 秋 冬 水
一 念 真 诚 通 法 座	在 西 天 二 十 八 祖
诗 圣 著 千 秋	波 光 欲 上 楼
人 物 已 超 前	老 雪 凝 千 古
绿 叶 栖 黄 鸟	白 浪 满 青 山
妙 手 生 白 玉	三 思 过 有 限
胜 游 从 此 起	一 花 一 世 界
八 千 余 年 上 下 古	七 十 二 家 文 字 奇
一 诗 二 表 三 分 鼎	万 古 千 秋 五 丈 原
楼 台 四 望 云 烟 合	草 木 一 溪 文 字 香
奇 石 尽 含 千 古 秀	亭 台 长 占 四 时 春
清 坐 使 人 无 俗 气	读 书 何 计 策 新 功
山 色 湖 光 杯 在 手	云 开 天 远 月 当 心
天 洞 连 天 天 连 洞	水 潮 来 水 水 来 潮
步 步 登 高 于 斯 且 往	遥 遥 直 上 别 有 可 观
泽 润 生 民	美 化 自 然
三 面 桥 通 四 面 水	万 古 云 霄 三 塔 影
谈 经 云 海 花 飞 雨	说 法 天 都 石 点 头
天 下 太 平 无 一 事	山 中 高 卧 有 千 秋
日 上 山 月 上 山 山 上 日 月 明	青 海 湖 水 海 湖 湖 海 青 水 清
白 云 白 鸟 飞 来 去	青 史 青 山 自 古 今
三 径 有 时 缘 客 扫	一 年 无 日 不 花 香
立 胆 为 义 昭 千 古	存 心 从 忠 著 万 年
天 天 饮 酒 天 天 醉	醉 醉 登 楼 醉 醉 天
半 百 光 阴 人 未 老	一 世 风 霜 志 更 坚
海 屋 筹 添 春 半 百	琼 池 桃 熟 岁 三 千
五 十 华 诞 开 北 海	三 千 朱 履 庆 南 山
元 龙 早 日 推 湖 海	安 石 中 年 有 竹 丝
杯 倾 北 海 辰 被 度	颂 献 南 山 甲 再 周
二 回 甲 子 春 初 度	举 国 笙 歌 醉 太 平
甲 子 重 新 新 甲 子	春 秋 几 度 度 春 秋
延 龄 人 种 神 仙 草	纪 算 新 开 甲 子 花
前 寿 五 旬 又 迎 花 甲	待 过 十 载 再 祝 古 稀
三 千 岁 月 春 常 在	六 一 丰 神 古 所 稀
休 辞 客 路 三 千 远	须 念 人 生 七 十 稀
从 古 称 稀 尊 上 寿	自 今 以 始 乐 余 年
人 如 天 上 珠 星 聚	春 到 筵 前 柏 酒 香
喜 逢 华 诞 歌 春 酒	好 向 新 年 戏 寿 衣
巧 逢 七 月 初 七 日	寿 祝 千 春 又 千 秋
东 海 筹 添 同 庆 祝	南 山 颂 献 赋 登 临
名 望 与 斗 山 并 重	年 龄 随 宫 线 同 添
三 十 初 进 延 龄 酒	百 年 喜 开 益 寿 花
五 福 备 至 已 五 十	百 寿 开 先 过 半 百
瑶 池 果 熟 三 千 岁	海 屋 筹 添 九 十 春
此 老 有 当 世 名	八 千 春 八 千 秋
六 合 同 春	寿 世 寿 民
春 秋 纪 合 八 千 岁	甲 子 周 回 三 万 旬
能 以 美 利 利 天 下	是 用 多 福 福 一 人
星 云 丽 近 中 秋 节	山 海 祥 开 益 地 图
甲 子 从 头 开 上 寿	神 仙 自 古 有 曾 孙
天 边 将 满 一 轮 月	世 上 还 钟 百 岁 人
宜 民 颂 起 延 年 后	寿 世 筵 开 浴 佛 光
已 过 一 万 八 千 日	应 知 四 十 九 年 非
德 为 世 重	寿 以 人 尊
福 如 东 海	寿 比 南 山
福 同 海 阔	寿 与 天 齐
立 功 立 德	寿 国 寿 民
名 高 北 斗	寿 比 南 山
人 增 高 寿	天 转 阳 和
松 苍 柏 翠	人 寿 年 丰
天 地 同 寿	日 月 齐 光
白 鹤 翔 万 里	红 桃 寿 千 秋
北 斗 临 台 座	南 山 献 寿 杯
福 如 东 海 大	寿 比 南 山 高
灵 芝 望 三 秀	玉 树 起 千 寻
青 松 多 寿 色	寿 添 沧 海 日
福 同 海 天 长	树 老 有 余 韵
年 高 多 雅 情	四 时 调 玉 烛
子 孙 万 代 福	松 龄 长 岁 月
鹤 语 纪 春 秋	仙 鹤 千 年 寿
苍 松 万 古 春	心 宽 能 增 寿
精 神 富 流 年	愿 献 南 山 寿
身 似 西 方 无 量 佛	寿 比 南 岳 老 人 星
室 有 芝 兰 春 自 韵	人 如 松 柏 岁 常 新
四 百 岂 惟 知 甲 子	八 千 应 复 数 春 秋
天 上 星 辰 应 作 伴	人 间 松 柏 不 知 年
仙 家 日 月 壶 公 酒	名 士 风 流 太 传 诗
宵 汉 鹏 程 腾 九 万	锦 堂 鹤 算 颂 三 千
功 和 龙 阁 名 垂 青 史	心 怀 虚 谷 安 度 晚 年
志 大 年 高 一 身 干 劲	童 颜 鹤 发 满 脸 春 风
凤 凰 枝 上 花 如 锦	松 菊 堂 中 人 并 年
千 岁 桃 开 连 理 木	万 年 枝 放 太 平 花
庆 佳 节 双 亲 长 寿	贺 新 春 五 谷 丰 登
紫 气 辉 煌 双 鹤 寿	春 风 浩 荡 百 花 香
西 望 瑶 池 降 王 母	南 极 老 人 应 寿 昌
紫 松 树 里 千 年 鹤	德 凤 池 边 五 色 云
一 夜 连 双 岁	五 更 分 两 年
一 年 春 作 首	万 事 公 为 先
天 心 随 律 转	人 事 逐 年 新
天 开 新 岁 月	人 改 旧 乾 坤
风 正 民 心 顺	人 和 国 自 安
节 日 人 共 乐	神 州 地 皆 春
旧 岁 已 呈 彩	新 年 始 到 门
新 风 遍 华 夏	美 景 展 神 州
腊 随 一 夜 去	春 逐 五 更 来
梅 花 闹 春 意	爆 竹 贺 新 年
春 风 迎 新 岁	瑞 雪 兆 丰 年
春 风 传 捷 报	梅 韵 贺 新 年
九 州 喜 度 元 春 日	四 海 欢 呼 大 有 年
人 歌 四 化 金 鸡 唱	岁 乐 千 春 紫 燕 飞
天 开 美 景 春 光 好	人 庆 丰 年 节 气 和
风 吹 大 地 迎 春 绿	日 照 人 心 向 党 红
六 花 喜 映 丰 收 果	四 化 欣 期 大 有 年
旧 岁 乘 风 传 捷 报	新 年 飞 雪 送 征 程
旧 岁 创 千 秋 大 业	新 年 描 四 化 蓝 图
腊 梅 朵 朵 迎 新 岁	瑞 雪 飘 飘 兆 丰 年
国 运 兴 隆 如 旭 日	事 业 发 达 胜 阳 春
祖 国 长 天 皆 丽 日	神 州 大 地 总 春 风
载 舞 载 歌 辞 旧 岁	同 心 同 德 贺 新 年
载 歌 载 舞 辞 旧 岁	自 唱 自 乐 迎 新 年
一 代 英 豪 九 州 生 色	八 方 捷 报 四 海 增 辉
一 元 复 始 九 州 同 庆	八 方 和 协 四 季 平 安
万 里 江 山 增 奇 添 彩	四 化 图 景 流 翠 飞 红
四 海 同 心 惠 风 和 畅	万 民 交 庆 化 日 舒 长
庆 佳 节 千 门 赞 国 策	迎 新 年 万 户 颂 党 恩
政 通 人 和 百 业 俱 兴	春 暖 花 开 千 山 呈 荣
万 户 千 家 齐 奔 现 代 化	五 湖 四 海 共 庆 胜 利 年
创 千 秋 伟 业 一 日 千 里	描 四 化 蓝 图 万 众 一 心
一 夜 连 双 岁 岁 岁 花 红 果 大	五 更 分 二 年 年 年 月 异 日 新
年 年 进 财 年 年 添 福 年 年 乐	岁 岁 丰 收 岁 岁 有 余 岁 岁 欢
万 家 元 夕 宴	一 路 太 平 歌
千 家 春 不 夜	万 里 月 连 宵
天 上 冰 轮 满	人 间 彩 灯 明
天 上 一 轮 满	人 间 万 里 明
元 夕 万 家 宴	宵 月 千 里 明
火 树 银 花 合	火 树 祥 光 丽
笙 歌 万 户 春	灯 楼 灿 明 月
火 树 暖 春 风	花 市 千 门 雪
华 月 送 清 歌	明 月 千 门 雪
开 心 乐 元 宵	春 阳 调 玉 烛
华 月 送 清 歌	银 花 开 火 树
灯 火 接 楼 台	锦 城 灯 接 彩
丹 桂 千 里 香	松 柏 万 年 青
雨 过 芳 草 润	春 到 杏 花 香
和 风 吹 柳 绿	细 雨 点 花 红
春 光 遍 草 木	佳 气 满 山 川
松 青 柏 翠 山 山 笑	柳 绿 梅 红 户 户 春
二 月 芳 辰 多 胜 景	百 花 诞 日 是 今 朝
为 妇 女 扬 眉 吐 气	与 男 儿 并 驾 争 雄
红 心 描 就 四 化 图	壮 志 顶 起 半 边 天
壮 志 结 成 四 化 果	红 心 顶 起 半 边 天
争 当 三 八 红 旗 手	敢 胜 九 州 胜 血 男
草 生 三 径 绿	山 拥 万 峰 青
松 竹 添 翠 色	桃 李 绽 春 风
青 山 四 面 合	绿 柳 万 家 春
雪 飞 梅 争 艳	春 来 柳 更 青
千 条 杨 柳 随 风 绿	万 里 山 河 映 日 红
芳 草 春 回 依 旧 绿	梅 花 时 到 自 然 香
春 夏 秋 冬 四 季 绿	东 西 南 北 九 州 香
春 夏 秋 冬 四 季 绿	树 果 花 草 遍 地 香
绿 山 绿 水 绿 色 美 绿 染 神 州	春 风 春 景 春 光 好 春 满 人 间
翠 竹 标 亮 节	红 梅 颂 高 风
清 风 明 月 本 无 价	近 水 遥 山 皆 有 情
海 国 天 中 节	江 城 五 月 春
克 勤 称 美 德	劳 动 最 光 荣
建 国 争 强 者	当 家 做 主 人
勤 俭 是 美 德	劳 动 最 光 荣
万 民 同 乐 凯 歌 里	四 化 共 喜 锦 绣 中
同 心 同 德 干 四 化	群 策 群 力 攀 高 峰
共 树 雄 心 为 祖 国	同 怀 壮 志 建 中 华
创 业 精 神 三 山 路	光 荣 传 统 五 月 歌
敢 想 敢 为 齐 奋 勇	边 改 边 革 共 腾 飞
敢 想 敢 为 齐 奋 勇	克 勤 克 俭 共 腾 飞
锦 绣 江 山 留 胜 迹	风 流 人 物 看 今 朝
策 马 登 程 奔 四 化	闻 鸡 起 舞 有 群 英
新 春 美 景 壮 国 色	盛 世 英 豪 皆 风 流
勤 俭 自 古 称 美 德	劳 动 如 今 更 光 荣
工 农 生 产 共 同 发 展	经 济 舞 台 全 面 繁 荣
自 学 成 才 才 可 济 世	勤 劳 致 富 富 能 兴 家
劳 动 光 荣 劳 工 神 圣	生 产 发 展 生 活 提 高
革 命 事 业 鹏 程 万 里	劳 动 人 民 力 量 无 边
革 命 红 旗 高 高 举 起	劳 动 本 色 代 代 相 传
祖 国 山 河 飞 花 点 翠	英 雄 儿 女 继 往 开 来
一 代 新 风 树	百 年 大 计 兴
江 山 红 万 代	革 命 传 千 秋
干 千 秋 伟 业	做 四 有 新 人
当 五 爱 青 年	做 四 有 新 人
青 春 红 似 火	大 志 壮 如 山
五 四 精 神 惊 百 代	万 千 美 景 待 一 笔
开 华 夏 千 秋 盛 举	展 神 州 万 古 雄 风
当 代 青 年 多 壮 志	今 朝 学 士 尽 英 才
壮 丽 青 春 绣 美 景	广 阔 天 地 放 英 华
革 命 江 山 兴 大 业	风 流 人 物 看 今 朝
前 辈 创 业 垂 青 史	长 征 接 力 有 后 人
鱼 跃 碧 海 赞 海 阔	鸟 飞 蓝 天 颂 天 高
锦 绣 河 山 添 壮 丽	英 雄 儿 女 着 先 鞭
数 风 流 还 看 当 代	好 儿 女 志 在 四 方
洒 汗 水 让 理 想 开 花 结 果	献 青 春 为 祖 国 耀 彩 增 辉
祖 国 青 年 争 创 人 间 奇 迹	炎 黄 儿 女 敢 超 世 界 水 平
树 木 树 人 长 成 国 家 梁 栋	全 心 全 意 攀 上 科 学 高 峰
早 立 凌 云 志	誓 当 接 力 人
祖 国 新 花 朵	未 来 小 主 人
一 代 英 雄 从 小 看	满 园 花 朵 向 阳 开
儿 童 乐 园 无 限 好	祖 国 花 朵 别 样 红
四 化 新 苗 经 雨 秀	三 春 花 朵 向 阳 花
六 一 儿 童 庆 佳 节	万 千 花 朵 正 宜 人
园 内 桃 李 年 年 秀	校 中 红 花 朵 朵 香
看 一 代 少 年 人 人 雄 姿 英 发	为 千 秋 伟 业 个 个 斗 志 昂 扬
春 到 人 间 向 阳 花 朵 迎 风 舞	喜 临 新 岁 幸 福 儿 童 带 笑 来
英 雄 辈 出 茂 林 新 叶 接 陈 叶	大 江 东 去 流 水 前 波 让 后 波
红 心 向 党 愿 将 青 春 献 祖 国	壮 志 凌 云 誓 为 四 化 建 奇 功
承 前 启 后 神 州 河 山 皆 秀 丽	继 往 开 来 华 夏 儿 女 更 风 流
红 日 千 秋 照	乾 坤 万 代 红
花 沐 春 雨 艳	福 依 党 恩 生
家 家 庆 年 盛	户 户 颂 党 恩
党 恩 春 荡 荡	家 庆 日 融 融
东 风 吹 绿 三 春 草	党 旗 映 红 四 化 花
岁 月 逢 春 花 遍 地	人 民 有 党 志 登 天
政 策 光 辉 昭 日 月	人 民 智 慧 焕 河 山
彩 笔 传 情 歌 伟 业	丹 霞 达 意 颂 党 恩
党 风 正 民 风 顺 社 会 风 气 好	国 事 兴 人 事 和 建 设 事 业 新
天 时 地 利 人 和 神 州 呈 福 兆	党 兴 民 福 国 强 中 华 必 腾 飞
好 主 义 好 路 线 好 政 策 般 般 都 好	新 中 国 新 时 代 新 面 貌 处 处 皆 新
江 山 金 汤 固	战 士 铁 甲 寒
祖 国 铁 龙 阵	人 民 子 弟 兵
人 民 战 士 千 古 美	革 命 英 雄 百 世 芳
白 云 丹 桂 边 关 色	明 月 清 风 将 士 心
光 荣 传 统 光 荣 史	钢 铁 长 城 钢 铁 兵
共 产 党 情 深 似 深	解 放 军 功 高 如 山
军 号 入 云 添 斗 志	战 旗 映 日 动 豪 情
祖 国 健 儿 保 祖 国	人 民 子 弟 爱 人 民
战 士 军 中 传 捷 报	英 雄 故 里 庆 和 平
前 辈 英 雄 开 创 革 命 千 秋 业	后 代 健 儿 永 保 江 山 万 年 红
为 国 而 教	作 人 之 师
尊 师 重 教	育 才 兴 邦
心 血 育 桃 李	辛 勤 扶 栋 梁
红 梅 知 春 早	翠 柏 识 岁 寒
须 尊 师 重 教	待 举 栋 兴 邦
碧 血 催 桃 李	丹 心 育 栋 梁
一 片 丹 心 随 世 古	千 声 赞 语 颂 师 恩
丹 心 一 片 育 新 苗	赞 歌 千 曲 颂 园 丁
立 足 三 好 育 桃 李	着 眼 四 化 出 栋 梁
生 敬 师 有 礼 有 貌	师 爱 生 同 志 同 心
白 发 喜 见 迎 春 柳	丹 心 笑 种 向 阳 花
辛 勤 育 得 花 朵 艳	汗 水 换 来 桃 李 香
终 身 育 才 人 人 敬	红 烛 火 种 代 代 传
举 国 尊 师 兴 伟 业	全 民 重 教 育 英 才
师 无 长 少 皆 称 老	学 有 高 低 总 是 生
尊 师 重 教 风 尚 美	文 明 礼 貌 气 象 新
人 民 万 岁	中 华 长 春
九 州 日 丽	四 化 春 新
万 民 有 庆	百 族 共 和
长 城 长 固	中 华 中 兴
龙 腾 虎 跃	燕 舞 莺 歌
江 山 不 老	神 州 永 春
神 州 奋 起	国 家 繁 荣
神 州 巨 变	祖 国 腾 飞
普 天 同 庆	日 月 增 辉
山 河 千 古 秀	平 野 万 象 新
山 河 十 月 秀	祖 国 万 年 春
万 民 皆 喜 庆	百 族 共 繁 荣
五 星 映 日 月	四 化 壮 河 山
文 明 新 社 会	锦 绣 好 河 山
江 山 千 古 秀	天 地 一 家 春
江 山 千 里 秀	祖 国 万 年 春
同 心 兴 大 业	携 手 振 中 华
百 族 歌 同 庆	九 州 喜 共 荣
国 富 山 河 壮	民 强 天 地 新
祖 国 春 如 海	人 民 力 胜 天
人 民 江 山 千 秋 固	祖 国 风 物 万 年 春
人 逢 国 庆 精 神 爽	月 到 中 秋 玉 宇 明
大 业 中 兴 歌 盛 世	神 州 此 日 正 高 秋
五 星 旗 红 映 日 月	四 季 花 放 妆 山 河
云 飞 神 州 彩 凤 舞	霞 舞 中 华 巨 龙 飞
民 生 有 幸 年 年 好	国 运 无 疆 日 日 长
共 和 国 光 辉 灿 烂	丰 收 年 气 象 更 新
江 山 如 画 千 年 秀	祖 国 多 娇 万 代 春
百 族 一 心 同 报 国	五 星 万 代 总 描 天
祖 国 山 河 无 限 好	人 民 天 下 万 年 长
祖 国 江 山 期 一 统	人 民 事 业 颂 千 秋
祖 国 与 天 地 同 寿	江 山 共 日 月 争 辉
祖 国 有 天 皆 丽 日	神 州 无 处 不 春 风
祖 国 花 好 人 同 乐	故 乡 月 明 燕 思 归
高 秋 好 赋 腾 飞 曲	盛 世 当 歌 奋 进 诗
锦 绣 河 山 非 昔 比	风 流 人 物 看 今 朝
锦 绣 河 山 添 锦 绣	光 明 中 国 更 光 明
惠 政 兴 邦 千 家 乐	赤 诚 报 国 万 众 心
鲜 花 遍 地 香 四 海	红 日 当 头 照 九 州
旗 展 五 星 光 日 月	花 开 四 季 丽 山 川
中 华 儿 女 顶 天 立 地	华 夏 子 孙 革 故 鼎 新
日 月 光 华 红 旗 万 岁	河 山 锦 绣 祖 国 长 春
四 化 春 色 春 盈 大 地	五 星 红 旗 红 满 长 天
两 个 文 明 日 新 月 异	四 化 建 设 国 富 民 强
乐 享 升 平 安 居 盛 世	风 拂 绿 柳 雪 绽 红 梅
莺 歌 燕 舞 普 天 同 庆	鸟 语 花 香 大 地 皆 春
百 花 争 艳 欣 望 江 山 千 里 秀	万 民 共 庆 欢 颂 祖 国 万 年 春
四 化 俱 兴 五 光 十 色 都 成 彩	百 花 齐 放 万 紫 千 红 总 是 春
华 夏 腾 飞 时 势 造 就 人 才 广	巨 龙 昂 首 英 雄 创 建 业 绩 丰
昌 盛 时 代 山 水 腾 跃 诗 画 里	大 兴 年 头 人 民 欢 笑 歌 舞 中
翠 柏 苍 松 装 点 祖 国 千 年 秀	朝 霞 夕 照 染 就 江 山 万 里 红
鼓 足 干 劲 创 造 人 民 万 代 福	力 争 上 游 迎 来 祖 国 四 化 春
民 富 国 强 数 今 朝 欢 笑 迎 国 庆	山 南 海 北 赞 改 革 歌 舞 颂 党 恩
碧 水 扬 波 鱼 跃 龙 腾 共 歌 国 德 厚	苍 山 吐 翠 花 繁 叶 茂 齐 赞 党 恩 深
载 歌 载 舞 迎 国 庆 赞 颂 华 夏 秋 色 好	同 心 同 德 干 四 化 喜 看 人 民 幸 福 多
天 下 为 公	世 界 大 同
谋 利 社 会	造 福 人 群
三 民 新 主 义	万 岁 大 中 华
天 开 新 世 界	春 焕 大 文 章
中 华 成 一 统	国 历 庆 新 年
中 山 英 明 全 球 望	世 界 大 同 尽 人 期
一 天 秋 似 水	满 地 月 如 霜
天 上 一 轮 满	人 间 万 家 明
天 上 一 轮 月	人 间 万 里 明
中 天 一 轮 满	秋 野 万 里 香
白 人 随 鹤 舞	明 月 逐 人 归
半 夜 二 更 半	中 秋 八 月 中
尘 中 人 自 老	天 际 月 常 明
尘 中 人 自 老	天 际 月 常 圆
春 秋 多 佳 日	山 水 有 清 音
绿 窗 明 月 在	青 史 古 人 无
明 月 本 无 价	高 山 皆 有 情
清 光 同 会 合	秋 色 正 平 分
露 从 今 夜 白	月 是 故 乡 明
一 逢 喜 事 精 神 爽	月 到 中 秋 光 辉 增
人 逢 喜 事 精 神 爽	月 到 中 秋 玉 镜 明
人 逢 喜 事 精 神 爽	月 到 中 秋 光 辉 增
三 五 良 宵 开 玉 宇	大 千 世 界 涌 冰 轮
三 五 良 宵 澄 银 汉	大 千 世 界 光 玉 轮
玉 轮 光 满 大 千 界	银 汉 秋 澄 三 五 宵
占 得 清 秋 一 半 好	算 来 明 月 十 分 圆
占 得 清 秋 一 半 好	应 推 明 月 十 分 圆
明 月 清 风 景 物 秀	神 州 春 色 画 图 新
三 五 良 宵 秋 澄 银 汉	大 千 世 界 光 满 玉 轮
桂 花 开 时 香 云 成 海	月 轮 高 处 广 寒 有 宫
银 汉 流 光 水 天 一 色	金 商 应 律 风 月 双 清
凤 岭 设 赏	龙 山 落 冠
黄 花 开 正 好	秋 雨 落 宜 时
敬 老 成 时 尚	举 贤 传 德 风
鼓 琴 仙 度 曲	种 杏 客 传 书
三 径 归 时 秋 菊 在	满 城 近 日 雨 风 多
三 径 归 时 岁 月 在	满 城 近 时 风 雨 多
年 高 喜 赏 登 高 节	秋 老 还 添 不 老 春
登 高 喜 度 老 年 节	赏 秋 畅 饮 菊 花 酒
柏 叶 春 回 处	梅 花 月 上 时
星 回 于 天 岁 云 暮	年 尽 此 夕 夜 如 何
爆 竹 声 中 催 腊 去	寒 梅 香 里 送 春 来
问 时 已 流 七 月 火	得 信 先 通 一 叶 桐
且 喜 一 阳 今 始 复	方 知 大 造 本 无 私
阳 历 残 年 逢 圣 诞	礼 仪 薄 物 送 亲 朋
杨 柳 旗 开 桃 花 浪 张	兰 亭 地 胜 曲 水 人 来
何 必 门 当 户 对	但 求 道 合 志 同
良 日 良 辰 良 偶	佳 男 佳 女 佳 缘
同 德 同 心 同 志	知 寒 知 暖 知 音
喜 共 花 容 月 色	何 分 秋 夜 春 宵
百 年 恩 爱 双 心 结	千 里 姻 缘 一 线 牵
百 事 开 怀 百 事 咏	两 心 相 重 两 心 知
长 天 欢 翔 比 翼 鸟	大 地 喜 结 连 理 枝
凤 凰 双 栖 桃 花 岸	莺 燕 对 舞 艳 阳 春
凤 翔 鸾 鸣 春 正 丽	莺 歌 燕 舞 日 初 长
海 阔 天 空 双 比 翼	月 好 花 好 两 知 心
海 阔 天 空 双 比 翼	志 同 道 合 两 知 音
合 家 畅 饮 新 婚 酒	夫 妇 同 吟 比 翼 诗
鸿 雁 贺 喜 衔 霜 叶	秋 风 迎 亲 带 桂 香
花 灿 银 灯 鸾 对 舞	春 归 画 栋 燕 双 栖
花 开 连 理 描 新 样	酒 饮 交 杯 醉 太 平
欢 庆 此 日 成 佳 偶	且 喜 今 朝 结 良 缘
黄 莺 高 唱 满 门 乐	喜 鹊 声 报 合 家 欢
吉 人 吉 时 传 吉 语	新 人 新 岁 结 新 婚
金 鸡 昂 首 祝 婚 礼	喜 鹊 登 梅 报 佳 音
连 理 枝 头 腾 凤 羽	合 欢 筵 上 对 鸾 杯
巧 借 花 容 添 月 色	欣 逢 秋 夜 作 春 宵
情 歌 唱 乐 水 中 月	喜 酒 催 开 庭 前 花
容 貌 心 灵 双 俊 美	才 华 事 业 两 风 流
入 户 春 风 月 圆 夜	盈 门 喜 气 花 好 时
十 雨 五 风 隆 化 育	五 光 十 色 映 红 妆
堂 栖 彩 燕 双 星 耀	岭 放 红 梅 万 象 新
堂 前 紫 燕 鸣 金 暖	窗 外 红 梅 斗 雪 开
堂 前 奏 笛 迎 宾 客	户 外 吹 笙 引 凤 凰
庭 前 日 暖 青 芝 秀	户 外 风 和 彩 凤 飞
同 谋 革 命 千 秋 业	共 建 勤 劳 百 世 家
喜 鹊 报 喜 举 家 喜	新 风 更 新 满 门 新
一 对 鸳 鸯 成 好 梦	五 更 鸾 凤 换 新 声
一 岭 桃 花 红 锦 绣	万 盏 银 灯 引 玉 人
莺 燕 双 栖 芳 草 地	凤 鸾 对 舞 艳 阳 天
白 首 齐 眉 鸳 鸯 比 翼	青 阳 启 瑞 桃 李 同 心
春 日 融 融 红 梅 朵 朵	花 香 阵 阵 彩 蝶 双 双
红 梅 含 笑 喜 成 连 理	绿 柳 吐 芳 永 结 同 心
红 梅 吐 芳 喜 成 连 理	绿 柳 含 笑 永 结 同 心
男 欢 女 爱 鸳 鸯 戏 水	情 投 意 合 鸾 凤 朝 阳
男 男 女 女 恩 恩 爱 爱	对 对 双 双 喜 喜 欢 欢
秋 水 银 堂 鸳 鸯 比 翼	天 风 玉 宇 鸾 凤 和 声
喜 气 绕 梁 梁 待 春 燕	金 光 满 屋 屋 迎 新 人
新 婚 新 偶 新 人 如 意	佳 景 佳 期 佳 月 称 心
一 杯 喜 酒 迎 宾 共 喜	两 颗 红 心 向 党 更 红
银 汉 双 星 蓝 田 合 壁	人 间 巧 节 天 上 佳 期
莺 歌 燕 舞 菊 花 吐 艳	水 笑 山 欢 丹 桂 飘 香
同 心 同 德 参 加 四 化 建 设	相 亲 相 爱 创 造 幸 福 家 庭
新 婚 新 偶 新 人 人 人 如 意	佳 丽 佳 期 佳 景 景 景 称 心
新 社 会 新 人 物 新 婚 嘉 礼	好 政 策 好 光 景 好 合 百 年
成 才 创 业 志 趣 相 投 同 地 久	报 国 兴 家 风 华 互 映 共 天 长
花 好 月 圆 岭 上 梅 花 双 喜 字	情 深 爱 永 筵 前 酒 醉 合 欢 杯
鸾 凤 谐 鸣 万 里 云 天 看 比 翼	夫 妻 恩 爱 百 年 事 业 结 同 心
相 爱 相 亲 家 和 人 寿 吉 星 照	同 心 同 德 水 秀 山 青 喜 事 连
相 敬 如 宾 好 好 和 和 四 季 乐	钟 情 似 海 恩 恩 爱 爱 百 年 长
志 同 道 合 同 德 同 心 花 吐 艳	日 新 月 异 新 人 新 事 桂 生 香
男 女 并 肩 为 锦 绣 江 山 添 异 彩	夫 妻 携 手 向 伟 大 祖 国 献 青 春
宝 马 送 来 天 上 客	香 车 送 出 月 中 人
碧 岸 雨 收 莺 语 柳	蓝 田 日 暖 玉 生 烟
采 莲 君 子 新 求 偶	雪 洁 佳 人 旧 有 才
沧 海 月 明 珠 献 彩	蓝 田 日 暖 玉 生 香
花 径 不 曾 缘 客 扫	蓬 门 今 始 为 君 开
画 眉 笔 带 凌 云 志	种 玉 人 怀 咏 雪 才
诗 歌 四 喜 其 三 句	乐 奏 周 南 第 一 章
新 笔 曾 题 红 叶 句	华 堂 欣 咏 友 琴 章
一 世 良 缘 歌 大 喜	百 年 好 合 结 新 婚
玉 堂 锦 马 三 学 士	清 风 明 月 二 仙 人
爆 竹 声 中 辞 旧 岁	华 灯 影 下 看 新 人
新 岁 新 婚 新 起 点	喜 人 喜 事 喜 开 端
长 征 奋 展 双 鹏 翼	四 化 昂 扬 万 里 心
经 营 春 夏 秋 冬 货	喜 惠 东 南 西 北 人
胸 有 赤 情 腾 骏 马	心 装 厚 爱 结 姻 缘
画 眉 笔 带 凌 云 气	斗 韵 才 惊 咏 雪 诗
同 庚 男 女 同 时 代	一 对 夫 妻 一 颗 心
有 酒 敬 邀 宾 客 醉	无 鱼 难 尽 主 人 情
大 驾 光 临 门 第 耀	良 辰 吉 聚 主 宾 欢
一 杯 美 酒 迎 宾 客	两 颗 赤 心 报 亲 恩
喜 期 喜 事 喜 中 有 喜	新 岁 新 人 新 上 加 新
花 烛 笑 迎 比 翼 鸟	洞 房 喜 开 并 头 梅
结 彩 张 灯 良 夜 美	鸣 鸾 和 凤 伴 春 来
日 丽 风 和 桃 李 笑	珠 联 壁 合 凤 凰 飞
花 从 春 来 香 能 久	爱 到 深 处 情 自 投
柳 色 映 眉 妆 镜 晓	桃 花 点 面 洞 房 春
大 地 风 光 喜 期 新 发	洞 房 花 烛 吉 日 良 辰
春 风 春 雨 春 常 在	喜 日 喜 人 喜 事 多
春 光 映 院 花 容 艳	喜 气 满 堂 人 意 和
春 临 大 地 迎 新 岁	喜 到 人 间 贺 佳 期
红 杏 枝 头 春 意 满	彩 门 楼 下 玉 箫 清
花 好 月 圆 欣 喜 日	桃 红 柳 绿 幸 福 时
佳 儿 佳 女 成 佳 偶	春 日 春 人 舞 春 风
乐 新 春 丰 年 宴 客	庆 喜 日 盛 世 联 姻
两 情 鱼 水 春 作 伴	百 年 恩 爱 花 常 红
两 情 鱼 水 春 作 伴	百 年 夫 妻 日 常 新
鸾 凤 和 鸣 昌 百 世	鸳 鸯 合 好 庆 三 春
山 青 水 碧 春 光 好	酒 绿 灯 红 喜 气 多
桃 花 人 面 红 相 映	杨 柳 春 风 绿 更 多
香 梅 迎 春 灯 结 彩	喜 气 入 户 月 初 圆
春 暖 花 朝 彩 鸾 对 舞	风 和 日 丽 红 杏 添 妆
花 好 月 圆 春 风 得 意	妻 贤 夫 德 幸 福 无 边
花 迎 贵 客 景 贵 富 贵	柳 沐 春 风 春 新 人 新
景 丽 三 春 天 台 桃 熟	祥 开 百 世 金 谷 花 娇
鸾 凤 和 鸣 春 光 满 目	燕 莺 比 翼 壮 志 凌 云
日 丽 风 和 果 结 如 意 树 上	春 暖 冰 融 花 开 幸 福 泉 边
朝 阳 彩 凤 双 双 舞	向 日 红 莲 朵 朵 开
玉 宇 欣 看 金 鹤 舞	画 堂 喜 听 彩 鸾 鸣
不 劳 鸿 雁 传 尺 素	且 喜 秋 声 入 洞 房
丹 桂 香 飘 云 路 近	玉 箫 声 绕 镜 台 高
鸾 凤 和 鸣 秋 光 满 月	雁 翔 比 翼 壮 志 凌 云
苍 松 翠 柏 沐 喜 气	玉 树 银 枝 迎 新 人
大 雁 比 翼 飞 万 里	夫 妻 同 心 乐 百 年
梅 花 芳 讯 先 春 试	柏 叶 吟 怀 小 雪 初
青 松 枝 头 白 鹤 为 偶	紫 竹 园 里 翠 鸟 成 双
将 相 传 家 真 有 种	阳 和 得 气 便 成 春
绣 阁 并 肩 春 望 月	红 楼 对 面 夜 弹 琴
门 前 绿 水 流 将 去	宅 后 紫 莺 祝 贺 来
贵 客 频 来 祝 大 喜	礼 房 笑 语 贺 佳 人
喜 联 双 吉 联 联 喜	双 对 喜 对 对 对 双
院 宅 祥 云 参 化 育	室 中 喜 气 乐 阳 春
万 卷 诗 书 宜 子 弟	一 帘 明 月 喜 新 人
堂 前 奏 乐 迎 宾 客	门 外 吹 箫 引 凤 凰
举 杯 未 饮 情 先 醉	奋 笔 疾 书 语 更 新
情 投 喜 奏 文 明 曲	意 合 欣 咏 幸 福 诗
座 上 漫 谈 同 志 爱	堂 前 合 庆 自 由 婚
自 去 自 来 堂 上 燕	相 亲 相 爱 水 中 鸳
五 风 春 绿 双 枝 树	十 雨 夏 滋 并 首 莲
克 俭 克 勤 成 大 业	全 心 全 意 为 人 民
铺 成 团 结 光 明 路	开 出 生 财 幸 福 泉
守 信 誉 经 营 财 源 通 四 海	保 优 良 生 产 商 品 达 三 江
夺 高 产 干 劲 添 辛 勤 结 硕 果	创 优 良 科 学 上 智 慧 绽 香 花
讲 道 德 讲 文 明 改 革 出 效 益	有 理 想 有 纪 律 生 产 创 一 流
光 腾 银 汉	辉 映 金 山
天 生 日 月 光 环 宇	地 有 金 银 富 国 家
一 片 乌 金 一 片 火	万 家 光 彩 万 家 明
经 营 有 大 志	建 造 集 良 工
大 厦 落 成 工 匠 巧	雄 文 草 就 秀 才 灵
建 成 大 厦 高 华 宅	留 与 后 人 久 远 居
替 国 增 光 修 大 厦	为 人 造 福 建 高 楼
高 山 须 厚 土	大 厦 要 良 材
有 材 已 入 选	无 地 不 育 林
黑 乌 在 火 里	清 白 留 人 间
全 体 乌 黑 在 火 里	一 身 清 白 在 人 间
春 风 初 识 面	明 月 本 无 心
一 尘 无 所 染	万 里 亦 能 光
但 愿 得 来 心 共 照	自 然 看 去 眼 共 明
秋 水 为 神 寒 冰 作 骨	春 风 识 面 明 月 当 身
四 周 佳 人 面	内 中 才 子 心
创 业 为 四 化	炼 钢 乐 千 秋
钢 花 除 旧 貌	铁 水 接 新 春
钢 花 照 地 灿	炉 火 耀 天 红
风 鼓 声 声 传 捷 报	钢 花 朵 朵 织 春 色
鼓 风 吹 绿 炉 边 柳	钢 火 映 红 心 上 花
虎 跃 龙 腾 奔 四 化	钢 花 铁 水 献 三 春
人 与 钢 花 同 灿 烂	心 随 铁 水 共 奔 流
天 空 云 彩 钢 花 织	华 夏 春 光 大 众 沐
铁 水 奔 流 红 喜 报	钢 花 灿 烂 耀 春 光
春 风 翻 雪 浪	炉 火 荡 金 波
能 教 黑 铁 变 雪 白	可 使 乌 物 现 银 光
白 天 红 日 亮	黑 夜 电 灯 明
红 日 照 万 里	电 灯 亮 千 家
雄 风 鼓 四 化	温 暖 送 千 家
逢 夜 不 愁 红 日 去	到 明 自 有 电 光 来
锦 绣 江 山 添 色 泽	光 明 世 界 增 辉 煌
千 家 万 户 得 温 暖	万 国 九 州 沐 光 辉
造 福 为 民 取 水 火	腾 飞 建 国 赖 能 源
能 工 范 土 术	休 笑 数 坛 才
青 烟 浮 六 合	翠 色 夺 千 峰
雨 过 天 青 千 古 色	花 留 水 彩 四 时 春
欲 待 春 花 明 锦 绣	先 从 晓 月 焕 丝 纶
妙 手 调 和 一 江 春 水	能 工 巧 染 五 色 祥 云
笔 底 能 出 千 样 彩	机 中 可 绽 万 般 花
万 言 日 出 生 花 笔	四 海 风 行 传 惠 书
春 到 山 乡 处 处 喜	喜 临 农 家 院 院 春
点 点 轻 舟 腾 巨 浪	阵 阵 渔 歌 卷 春 风
鸟 鸣 花 艳 春 光 好	人 寿 年 丰 喜 事 多
勤 俭 人 家 先 致 富	向 阳 花 木 早 逢 春
山 青 水 秀 风 光 好	人 寿 年 丰 喜 事 多
新 人 新 事 新 风 尚	好 风 好 雨 好 年 成
政 策 入 心 化 春 雨	汗 珠 落 地 夺 丰 年
人 民 江 山 春 风 万 里	社 会 主 义 幸 福 千 秋
白 帆 春 暖 兴 渔 业	碧 海 波 平 唱 福 音
帆 舞 东 风 征 大 海	门 临 旭 日 乐 渔 家
海 上 渔 歌 随 浪 涌	岸 边 欢 笑 逐 风 飞
万 国 嘉 宾 舟 载 宝	三 山 奇 景 海 连 云
万 里 烟 霞 凭 啸 傲	半 江 云 水 作 生 涯
五 岭 山 歌 传 喜 讯	三 江 渔 唱 起 春 潮
一 海 浪 涛 一 海 笑	满 船 歌 曲 满 船 鱼
雨 顺 风 调 人 出 海	帆 轻 云 淡 船 归 家
水 绿 山 青 光 景 好	花 香 草 茂 马 牛 肥
草 绿 山 青 阳 春 有 脚	羊 肥 马 壮 幸 福 无 边
科 学 种 田 山 川 喜 披 一 片 锦	多 方 致 富 财 源 茂 盛 四 时 乐
春 风 得 意 花 千 里	秋 月 扬 辉 桂 一 枝
风 吹 杨 柳 千 山 绿	雨 润 杏 桃 万 里 红
柳 绿 杏 黄 千 载 福	桃 红 松 翠 万 年 春
青 山 不 语 花 常 笑	绿 水 无 音 鸟 作 歌
松 色 巧 开 千 岭 绿	梅 香 普 送 万 家 春
万 木 欣 春 随 水 绿	百 花 争 艳 向 阳 红
一 片 晓 烟 杨 柳 绿	满 园 春 色 杏 桃 红
翠 柏 苍 松 装 成 祖 国 千 年 秀	朝 霞 夕 照 染 就 江 山 万 代 红
财 源 茂 盛	生 意 兴 隆
昌 明 德 载	价 实 货 真
春 风 满 面	顾 客 盈 门
福 高 德 载	源 远 流 长
公 平 事 业	利 益 文 章
公 平 有 德	和 气 致 祥
鸿 图 大 展	事 业 有 成
门 迎 喜 气	店 满 春 风
十 分 春 意	满 店 热 情
四 方 来 宝	八 路 进 财
万 民 便 利	百 货 畅 通
文 明 待 客	礼 貌 经 商
一 团 和 气	四 面 春 风
盈 余 得 利	丰 富 多 财
财 源 通 四 海	客 路 达 三 江
多 想 生 财 道	广 开 致 富 门
富 自 勤 中 得	誉 从 信 里 来
厚 生 资 利 用	和 众 兆 丰 财
货 好 人 常 美	心 公 客 必 来
经 商 诚 作 本	待 客 暖 如 春
开 业 逢 盛 世	发 财 在 今 朝
巧 理 千 家 事	温 暖 万 人 心
商 标 昭 信 用	服 务 竞 文 明
生 意 如 春 意	财 源 似 水 源
信 誉 通 交 易	公 平 作 往 来
畅 销 全 球 上 品	诚 待 举 世 佳 宾
交 以 道 接 以 礼	近 者 悦 远 者 来
乐 滋 滋 为 四 化	笑 盈 盈 迎 顾 客
入 店 皆 为 上 客	进 门 胜 似 亲 人
树 信 树 诚 待 客	互 惠 互 得 经 商
远 悦 近 来 客 乐	价 廉 物 美 财 丰
诚 信 经 营 多 得 利	公 平 交 易 永 生 财
根 深 叶 茂 无 疆 业	源 远 流 长 有 道 财
顾 客 四 方 传 美 誉	柜 台 三 尺 有 新 风
花 开 时 节 店 如 锦	客 至 柜 台 喜 若 春
货 向 万 人 千 户 送	门 朝 四 海 五 湖 开
经 商 信 用 通 千 国	营 业 仁 风 达 五 洲
经 营 得 法 家 家 富	管 理 有 条 事 事 通
礼 貌 待 人 人 品 厚	文 明 处 世 世 情 隆
礼 貌 经 商 商 业 旺	文 明 待 客 客 人 多
联 营 商 品 财 源 广	起 用 能 人 事 业 兴
买 卖 公 平 招 顾 客	交 流 合 理 悦 来 宾
人 往 人 来 皆 笑 脸	店 中 店 外 尽 欢 声
三 尺 柜 台 传 暖 意	一 张 笑 脸 带 春 风
三 阳 开 泰 财 源 茂	四 化 成 功 国 运 昌
生 意 兴 隆 通 四 海	财 源 茂 盛 达 三 江
实 业 人 创 千 秋 业	长 春 花 开 万 里 春
四 海 经 商 无 假 货	一 生 处 事 做 真 人
文 明 待 客 心 灵 美	礼 貌 经 商 言 语 和
文 明 经 商 心 常 乐	礼 貌 待 客 业 自 兴
向 阳 商 店 连 千 户	友 善 柜 台 喜 万 家
友 善 真 诚 迎 顾 客	热 情 周 到 待 嘉 宾
友 以 义 交 情 可 久	财 从 德 取 利 方 长
白 雪 拥 门 门 庭 凝 瑞	红 梅 开 店 店 铺 呈 祥
百 业 鼎 新 一 团 热 火	万 商 云 集 满 面 春 风
百 业 兴 隆 万 家 欢 乐	千 商 云 集 一 市 繁 荣
管 理 无 私 诚 开 金 石	经 营 有 道 誉 胜 文 章
货 出 岭 南 五 光 十 色	名 传 燕 北 日 异 月 新
货 架 上 下 繁 花 似 锦	柜 台 内 外 笑 脸 如 春
礼 貌 经 商 来 宾 至 上	文 明 服 务 信 誉 为 先
礼 貌 经 商 门 庭 若 市	文 明 待 客 宾 至 如 归
礼 貌 经 商 胸 怀 四 化	文 明 待 客 心 系 千 家
联 合 经 营 互 惠 互 利	热 情 服 务 全 意 全 心
灵 活 经 营 财 源 茂 盛	热 情 服 务 生 意 兴 隆
灵 活 经 营 财 源 茂 盛	薄 利 多 销 生 意 兴 隆
满 面 春 风 喜 迎 宾 至	四 时 生 意 全 在 人 为
三 尺 柜 台 张 张 笑 脸	一 间 商 店 处 处 春 风
文 明 经 商 热 情 常 在	笑 脸 迎 客 生 意 兴 隆
以 三 尺 柜 台 迎 贵 宾	待 八 方 顾 客 如 亲 人
有 道 经 营 财 源 茂 盛	热 情 服 务 顾 客 盈 门
政 策 随 心 百 业 兴 旺	春 风 得 意 万 象 更 新
祖 国 繁 荣 百 业 兴 旺	春 光 灿 烂 万 物 新 生
薄 利 多 销 利 逐 春 潮 涌	横 财 不 取 财 如 旭 日 升
买 进 卖 出 原 本 千 秋 业	送 往 迎 来 温 暖 万 人 心
为 人 民 服 务 全 心 全 意	替 顾 客 着 想 有 始 有 终
供 应 畅 通 连 接 五 湖 四 海	经 销 兴 旺 温 暖 万 户 千 家
柜 台 三 尺 情 暖 千 家 万 户	商 店 一 间 心 连 四 海 五 湖
经 营 有 道 不 在 店 大 店 小	礼 貌 待 人 何 分 年 少 年 高
经 营 有 道 货 备 五 湖 四 海	服 务 周 全 心 怀 万 户 千 家
苦 心 经 营 提 高 经 济 效 益	热 情 服 务 建 设 精 神 文 明
品 种 齐 全 销 春 夏 秋 冬 货	服 务 周 到 迎 东 西 南 北 人
外 行 变 内 行 行 行 呈 异 彩	后 浪 追 前 浪 浪 浪 有 奇 峰
公 平 买 卖 三 尺 柜 台 连 四 海	文 明 经 商 一 颗 红 心 系 万 家
互 惠 互 利 文 明 经 商 迎 万 客	树 诚 树 信 公 平 交 易 通 八 方
精 美 齐 全 销 春 夏 秋 冬 之 货	热 情 周 到 迎 东 西 南 北 之 人
礼 貌 经 商 柜 台 内 外 添 春 色	文 明 待 客 城 乡 上 下 喜 开 怀
买 进 卖 出 关 系 万 户 千 家 事	迎 来 送 往 接 待 三 江 四 海 人
门 路 多 东 南 西 北 头 头 是 道	经 营 活 春 夏 秋 冬 季 季 丰 收
文 明 经 商 门 庭 若 市 春 满 店	礼 貌 待 客 宾 至 如 家 暖 人 心
营 业 有 方 奇 货 满 堂 生 意 好	热 情 周 到 嘉 宾 盈 店 买 卖 活
重 信 誉 生 财 有 道 财 源 茂 盛	守 法 纪 货 真 价 实 买 卖 兴 隆
放 眼 神 州 四 化 前 程 无 限 美 好	立 身 本 业 三 尺 柜 台 大 有 作 为
服 务 争 雄 新 全 活 巧 物 色 独 具	灵 通 取 胜 中 外 古 今 运 筹 皆 然
百 货 尽 有	一 应 俱 全
千 家 便 利	百 货 流 通
振 兴 百 业	云 集 万 民
柜 里 春 风 暖	店 中 百 货 全
柜 台 花 似 锦	顾 客 面 如 春
价 廉 销 路 广	物 美 招 人 多
云 霞 呈 五 色	锦 绣 展 千 重
百 货 俱 全 商 品 好	万 方 云 集 店 风 佳
百 货 商 店 百 般 便	一 回 交 易 一 场 欢
柜 上 喜 迎 四 海 客	门 前 欢 送 八 方 宾
聚 宝 藏 珍 凝 瑞 气	兴 家 创 业 起 风 光
盛 意 招 呼 迎 客 至	热 情 服 务 送 君 归
五 湖 生 意 如 云 集	四 海 财 源 似 水 来
近 悦 远 来 转 运 百 货	水 程 陆 路 惠 利 群 商
百 货 商 店 店 里 百 货 如 意 店	一 颗 爱 心 心 中 一 颗 为 民 心
四 壁 生 辉 春 色 一 楼 争 锦 绣	八 方 来 客 商 城 百 货 占 风 流
万 紫 千 红 满 店 春 光 皆 锦 绣	树 诚 守 信 文 明 经 商 通 四 方
服 物 从 新 制	行 装 改 旧 观
敢 斗 心 裁 巧	全 凭 手 艺 工
接 来 千 丈 布	绣 出 万 家 春
美 女 妆 华 服	高 人 着 布 衣
妙 手 裁 去 锦	精 心 剪 春 光
同 心 垂 领 结	制 服 称 身 材
衣 人 身 自 暖	被 世 岁 无 寒
好 将 妙 手 夸 针 巧	漫 把 春 光 细 剪 裁
剪 绿 裁 红 妆 彩 色	迎 男 送 女 美 仪 容
剪 绿 裁 红 妆 丽 色	挑 花 绣 蕊 美 仪 容
量 体 裁 衣 真 妙 手	穿 针 引 线 有 高 才
时 装 任 我 精 心 制	美 服 凭 君 着 意 挑
铁 剪 裁 开 双 凤 舞	金 针 引 动 独 鸿 飞
一 剪 喜 成 千 户 愿	寸 功 巧 度 万 人 心
云 霞 托 出 一 轮 月	锦 绣 拥 来 万 朵 花
中 西 内 外 时 装 美	春 夏 秋 冬 面 样 新
量 体 裁 衣 匠 心 别 具	穿 针 引 线 妙 手 常 新
一 寸 布 一 寸 丝 物 尽 其 用	不 自 高 不 自 大 量 体 裁 衣
经 纶 天 下	衣 被 苍 生
布 衣 衣 大 雅	此 中 皆 锦 绣
文 采 自 风 流	辛 勤 弹 一 曲
温 暖 送 千 家	玉 剪 忙 裁 月
不 愁 红 日 去	还 有 夜 珠 来
不 愁 夕 阳 去	还 有 夜 珠 来
花 放 山 河 丽	光 照 天 地 新
取 材 天 欲 笑	入 夜 月 同 明
日 辉 丹 凤 舞	霞 焕 白 龙 腾
光 耀 九 天 能 夺 目	辉 煌 一 室 胜 悬 珠
新 花 雪 白 晴 能 舞	古 调 琴 声 静 可 弹
欲 知 世 上 丝 纶 美	且 看 庭 前 锦 绣 鲜
愿 将 天 上 云 霞 服	裁 作 人 间 锦 绣 衣
愿 为 群 众 经 纶 业	特 著 顾 客 衣 被 功
直 线 曲 线 都 开 眼	中 装 西 装 总 入 时
利 剪 频 挥 巧 裁 天 上 云 霞 彩	飞 轮 急 转 精 制 人 间 锦 绣 衣
门 度 彩 云 银 剪 裁 云 分 万 户	店 纳 活 水 玉 尺 引 水 接 三 江
瑞 气 盈 门 凤 吐 经 纶 成 七 彩	祥 光 洒 地 龙 盘 锦 绣 灿 千 花
劲 节 思 君 子	虚 心 应 世 人
精 工 为 世 用	美 器 在 人 成
虚 心 成 大 器	劲 节 见 奇 才
佳 木 由 来 堪 作 器	良 工 自 古 不 遗 材
曲 尺 能 成 方 圆 器	直 线 调 出 栋 梁 材
与 人 相 处 无 非 义	生 意 之 间 即 是 春
出 品 必 精 价 廉 物 美	制 器 须 固 外 巧 内 坚
和 声 鸣 盛 世	雅 乐 协 元 音
和 声 鸣 盛 世	鼓 乐 庆 升 平
闻 声 齐 合 律	欣 赏 即 知 音
如 钟 以 应 也	必 表 而 出 之
二 十 四 时 凭 我 报	万 千 百 事 任 君 行
千 秋 伟 业 千 秋 福	一 寸 光 阴 一 寸 金
制 法 巧 于 记 里 鼓	定 时 妙 胜 报 更 筹
慧 光 迎 面 观 无 际	暮 岁 点 头 转 少 年
生 来 日 月 重 华 世	业 得 神 仙 不 老 方
惟 愿 得 来 心 共 照	自 然 看 去 眼 同 明
光 辉 腾 满 室	金 碧 耀 层 楼
金 乃 五 行 首	银 为 百 样 珍
楼 阁 五 云 起	金 银 百 宝 盈
银 花 腾 异 采	宝 树 斗 奇 辉
知 君 室 吉 星 高 照	来 我 家 喜 气 将 临
指 上 一 轮 明 月 满	耳 边 两 朵 彩 霞 飞
珠 名 称 宝 树	花 样 更 时 新
催 花 不 用 滋 荣 术	剪 彩 能 深 造 物 工
乘 时 堪 博 古	入 世 亦 居 奇
频 劳 工 匠 巧	博 得 小 儿 欢
吹 吹 打 打 般 般 妙	绿 绿 红 红 样 样 精
恩 物 最 宜 开 智 慧	神 工 尽 力 作 精 裁
春 城 欣 百 业	花 市 拥 群 芳
山 中 无 岁 月	花 草 有 春 秋
题 鸟 门 留 字	求 凰 曲 弄 琴
花 迎 酒 客 容 先 醉	草 见 诗 人 色 更 青
笑 看 秋 菊 心 田 广	乐 对 冬 梅 胆 气 豪
一 池 碧 水 映 圆 月	九 州 花 木 沐 春 风
一 花 独 放 不 成 锦	万 紫 千 红 总 是 春
翠 木 枝 枝 无 穷 雅 韵	鲜 花 朵 朵 占 尽 风 流
异 草 奇 花 装 成 春 色	幽 兰 雅 菊 美 化 市 容
天 上 明 河 银 作 水	海 中 仙 树 玉 为 林
但 愿 世 间 人 常 寿	不 惜 架 上 药 生 尘
但 愿 世 间 人 无 病	何 愁 架 上 药 生 尘
拂 去 白 云 忙 采 药	引 来 明 月 炼 金 丹
金 丹 益 气 增 长 寿	国 药 养 神 保 健 康
灵 丹 普 济 传 千 载	妙 药 广 施 乐 万 人
世 界 本 无 长 生 术	海 外 岂 有 不 老 丹
五 岳 三 山 收 仙 草	九 州 四 海 除 病 根
喜 有 药 材 称 道 地	更 看 医 术 可 回 天
宜 向 市 中 求 妙 药	须 知 仙 山 无 奇 方
欲 向 市 中 求 妙 药	须 知 海 内 有 奇 方
黄 润 紫 团 功 殊 高 妙	玉 兰 金 井 品 重 杏 林
神 州 药 苑 百 草 吐 芳	誉 满 杏 林 寿 身 寿 世
清 香 飘 远 近	润 色 著 芳 华
香 水 春 云 润	粉 面 艳 阳 开
五 光 呈 异 彩	十 色 灿 文 章
金 碧 丹 青 姿 色 泽	宽 门 高 阁 焕 光 华
五 彩 云 霞 资 利 用	三 江 锦 绣 焕 光 华
可 使 寒 冬 成 暖 室	能 将 炎 夏 变 凉 秋
采 向 山 林 夸 富 足	取 来 木 石 得 精 华
传 播 四 海 新 文 化	推 广 九 州 有 用 书
欲 知 今 古 千 年 事	且 读 中 西 万 本 书
远 求 海 内 珍 藏 本	快 读 人 间 未 见 书
笔 端 通 造 化	意 表 出 云 霞
沧 海 驾 紫 浪	泰 岳 吐 春 云
草 书 何 太 古	诗 兴 不 无 神
丹 青 工 设 色	变 化 妙 通 神
观 画 如 观 景	观 画 胜 光 景
赏 字 如 赏 花	挥 毫 列 锦 绣
流 云 席 上 看	兰 香 满 素 室
月 色 映 书 窗	青 山 收 笔 底
帆 影 晚 山 红	润 笔 看 凤 舞
和 墨 化 龙 飞	山 光 清 眼 界
书 味 润 心 田	诗 情 光 日 月
笔 力 动 乾 坤	书 法 扬 道 义
长 毫 写 新 书	推 窗 观 天 地
挥 毫 凌 云 烟	香 飘 风 物 外
诗 入 画 图 中	雨 过 琴 书 润
须 读 五 车 书	云 闲 花 秀 丽
风 静 竹 平 安	展 开 秦 岭 月
切 来 云 片 薄	制 出 月 华 新
素 雅 为 佳 松 竹 绿	幽 淡 最 奇 芝 兰 香
制 出 月 华 圆 若 镜	切 来 云 片 薄 如 罗
欲 将 云 锦 裁 成 服	先 把 金 针 度 与 人
好 把 容 颜 相 对 照	莫 将 世 界 放 光 明
新 镜 美 含 千 种 色	名 花 色 列 四 时 春
好 货 销 海 外	盛 誉 满 国 中
实 施 住 房 商 品 化	造 福 当 代 百 万 人
发 电 农 村 为 四 化	照 明 新 屋 喜 千 家
繁 荣 市 场 财 源 旺	礼 貌 经 商 客 自 多
克 俭 克 勤 能 致 富	有 知 有 识 定 成 才
无 穷 生 意 赖 乡 土	有 志 农 民 是 栋 材
实 行 因 地 制 宜 生 财 得 道	发 展 多 头 经 济 致 富 有 门
顾 客 盈 门 买 卖 活 经 营 有 路	供 销 皆 旺 生 意 好 聚 财 有 方
闻 香 下 马	知 味 停 车
杯 中 倾 竹 叶	面 色 绽 桃 花
杯 中 倾 竹 叶	人 面 笑 桃 花
道 道 非 常 道	天 天 小 有 天
店 好 千 家 颂	坛 开 十 里 香
海 上 生 明 月	天 边 作 酒 星
酒 外 乾 坤 大	壶 中 日 月 长
举 杯 歌 盛 世	对 酒 庆 丰 年
楼 小 乾 坤 大	酒 香 顾 客 多
巧 做 千 家 饭	温 暖 万 客 心
人 游 千 里 外	兴 在 一 杯 中
入 座 一 杯 酒	登 程 满 路 香
诗 甘 称 弟 子	酒 不 让 先 生
闻 名 心 也 醉	品 味 梦 犹 香
闻 香 须 下 马	知 味 且 停 车
闻 香 宜 下 马	愿 醉 且 登 楼
一 醉 千 愁 解	三 杯 万 事 和
其 味 非 羊 能 易	此 间 有 鸡 更 佳
最 宜 藏 北 陆	未 必 解 东 风
一 人 巧 作 千 人 饭	五 味 调 和 百 味 香
三 江 美 味	四 海 奇 珍
四 时 佳 品	一 店 鲜 活
奇 珍 来 海 国	异 味 备 天 窗
半 夜 早 潮 声 入 梦	一 江 春 水 暖 先 知
迎 年 须 早 备	祝 寿 更 相 宜
淡 酒 邀 明 月	香 茶 迎 故 人
酒 醉 英 雄 汉	茶 引 博 士 文
客 上 天 然 居	居 然 天 上 客
客 至 心 常 热	人 走 茶 不 凉
日 日 无 空 座	时 时 有 好 茶
扬 子 江 心 水	黄 山 顶 上 茶
一 天 无 空 座	四 时 有 香 茶
茶 敬 客 来 茶 当 酒	云 山 云 去 云 作 车
茶 亦 醉 人 何 必 酒	书 能 香 我 不 须 花
春 满 壶 中 留 客 醉	茶 香 座 上 待 君 来
壶 在 心 中 天 在 壶	心 在 壶 中 地 在 心
近 水 楼 台 先 得 月	芳 香 茶 叶 最 清 心
柳 井 有 泉 好 作 饮	君 山 无 处 不 宜 茶
为 品 清 香 频 入 座	欢 同 知 心 细 谈 心
雨 日 好 留 佳 客 饮	春 风 时 送 鸟 声 来
只 缘 碧 玉 成 清 趣	好 在 香 茶 出 雅 情
滋 味 美 如 花 上 露	清 凉 净 似 石 中 泉
佳 讯 从 天 降	喜 音 逐 电 来
能 传 千 里 话	可 通 万 种 情
平 安 劳 远 报	消 息 喜 常 通
日 送 千 家 信	时 通 万 户 情
送 九 州 书 信	传 四 海 佳 音
消 息 从 天 降	音 书 逐 电 来
电 波 银 线 传 情 意	鸿 雁 绿 衣 报 好 音
电 波 远 播 千 家 讯	绿 使 遥 传 万 里 书
捷 报 频 传 山 海 事	佳 音 快 达 故 人 情
胜 利 消 息 劳 远 报	平 安 书 信 喜 常 通
万 里 飞 鸿 书 致 意	五 洲 通 报 电 呈 情
万 里 远 牵 乡 国 梦	一 丝 长 系 故 人 情
红 线 达 传 九 州 芳 讯	电 波 播 送 万 国 新 闻
四 海 九 洲 鱼 来 雁 往	千 家 万 户 信 达 书 传
送 佳 音 飞 车 连 万 户	传 喜 讯 银 线 达 三 江
鸿 雁 来 宾 破 雾 穿 云 传 捷 报	绿 衣 使 者 翻 山 越 岭 沐 春 风
进 进 出 出 佳 音 送 五 洲 四 海	来 来 往 往 登 报 传 万 户 千 家
一 路 送 春 风 温 暖 千 家 万 户	八 方 传 喜 讯 鼓 舞 北 地 南 天
金 针 出 妙 手	白 衣 怀 丹 心
良 医 同 良 相	用 药 如 用 兵
巧 手 医 千 病	红 心 暖 万 家
白 衣 红 心 称 妙 手	高 术 精 艺 治 难 疾
丹 心 妙 手 除 固 疾	草 药 银 针 有 万 能
妙 手 回 春 医 百 病	灵 丹 济 世 乐 千 家
体 健 身 强 离 我 远	慈 心 妙 手 祝 君 康
问 切 望 闻 回 春 素 手	热 寒 表 内 济 世 丹 心
学 贯 中 西 活 人 无 数	术 精 内 外 济 世 良 多
医 护 合 作 一 心 为 病 友	中 西 团 结 协 力 创 良 功
户 户 皆 为 清 洁 户	人 人 都 是 健 康 人
户 户 家 家 处 处 干 干 净 净	男 男 女 女 人 人 喜 喜 欢 欢
城 市 清 洁 环 境 美	山 河 壮 丽 画 图 新
夺 标 常 有 望	积 款 自 成 多
保 来 四 面 八 方 泰	险 去 千 家 万 户 欢
财 产 有 价 快 保 险	水 火 无 情 早 防 灾
金 融 富 似 春 初 草	事 业 繁 如 锦 上 花
鸟 向 青 山 春 光 好	人 投 保 险 好 处 多
人 人 保 险 人 人 乐	户 户 平 安 户 户 歌
迎 春 歌 唱 九 州 乐	保 险 花 开 万 户 欢
户 户 家 家 人 人 保 险	年 年 月 月 日 日 平 安
日 异 月 新 与 年 俱 进	流 长 源 远 效 益 无 涯
随 来 随 保 为 民 着 想	防 险 防 灾 替 国 分 忧
去 去 来 来 人 人 欢 欢 喜 喜	多 多 少 少 日 日 取 取 存 存
营 业 室 中 颗 颗 红 心 竞 艳	收 钱 台 上 张 张 笑 脸 迎 春
保 身 保 物 保 财 产	利 己 利 人 利 国 家
房 屋 资 财 堪 入 保	风 云 雷 电 也 无 忧
千 家 保 险 千 家 乐	万 户 平 安 万 户 欢
欣 为 牛 郎 系 红 线	喜 替 织 女 架 鹊 桥
家 门 不 半 步	天 下 事 全 知
映 五 洲 美 景	传 四 海 英 姿
平 心 观 世 界	放 手 写 春 秋
热 心 歌 四 化	彩 笔 颂 群 英
神 州 新 气 象	华 国 大 文 章
才 能 伴 信 息 显 现	理 想 随 事 业 腾 飞
日 出 万 言 生 花 笔	风 行 四 海 动 人 书
爱 伟 大 山 川 歌 壮 丽 事 业	颂 英 雄 民 众 赞 光 辉 功 绩
行 千 里 路	读 万 卷 书
藏 书 千 万 卷	增 智 九 州 人
读 书 破 万 卷	落 笔 超 群 英
读 书 破 万 卷	下 笔 如 有 神
读 书 破 万 卷	下 笔 有 千 言
书 中 天 地 大	笔 下 空 间 宽
学 海 宽 千 里	书 山 高 万 寻
友 古 今 名 士	读 中 外 益 书
欲 知 天 下 事	须 读 古 今 书
欲 知 中 外 事	须 读 古 今 书
长 留 天 地 无 穷 趣	最 爱 书 田 不 老 春
欢 迎 读 者 游 学 海	爱 接 仁 人 攀 书 山
书 画 同 源 扬 国 艺	图 文 并 茂 益 书 生
中 外 名 书 藏 满 架	古 今 精 品 聚 一 楼
一 堂 珍 品	千 古 奇 观
越 王 宝 剑	孙 子 兵 书
有 六 朝 石 刻	藏 三 代 金 钟
戏 游 一 席 地	艺 趣 万 人 心
超 出 乾 坤 为 物 外	到 来 天 地 是 人 间
声 歌 盛 世	乐 庆 丰 年
百 业 兴 隆 歌 盛 世	三 春 艳 丽 乐 明 时
风 琴 采 中 西 异 制	军 乐 为 今 古 殊 声
流 水 高 山 会 心 不 远	阳 春 白 雪 和 曲 其 谁
歌 飞 六 合 诗 声 美	画 漫 九 州 春 色 新
今 人 能 为 古 人 曲	听 者 当 知 弹 者 情
金 谷 园 中 罗 锦 绣	玉 楼 天 半 起 笙 歌
似 锦 河 山 连 片 画	如 花 生 活 满 园 诗
欢 乐 歌 欢 乐 舞 歌 舞 皆 欢 乐	丰 收 诗 丰 收 画 诗 画 尽 丰 收
群 星 灿 烂 辉 体 苑	一 代 风 流 扬 国 威
争 光 爱 国 健 儿 志	建 业 为 民 赤 子 心
中 华 勇 士 多 奇 志	世 界 体 坛 争 上 游
开 展 人 民 强 身 活 动	提 高 民 族 康 健 水 平
立 壮 志 为 中 华 民 族 永 争 光 彩	树 雄 心 把 世 界 水 平 再 写 新 篇
体 苑 新 人 凌 云 壮 志 鹏 程 万 里	沙 场 老 手 打 虎 雄 风 威 振 五 洲
科 学 打 通 幸 福 路	革 新 架 起 富 民 桥
无 心 赏 月 中 丹 桂	有 志 攀 山 上 险 峰
四 化 腾 飞 赖 科 学 振 翼	九 州 奋 进 凭 改 革 加 鞭
政 策 暖 人 心 心 心 向 党	科 学 铺 富 路 路 路 朝 阳
追 日 月 星 辰 鹏 程 万 里	奔 东 西 南 北 志 在 八 方
东 风 吹 奏 园 丁 曲	大 地 迎 来 桃 李 歌
满 屋 诗 书 添 丽 景	盈 门 桃 李 笑 春 风
惟 热 心 人 可 与 其 学	且 诚 意 者 得 入 斯 堂
桃 李 满 园 全 靠 春 风 时 雨 润	人 才 遍 地 尽 是 明 师 巧 匠 工
车 轮 滚 滚 描 长 卷	公 路 条 条 奔 小 康
飞 轮 滚 滚 歌 一 路	马 达 声 声 传 万 家
千 里 路 朝 行 夕 至	两 地 人 南 往 北 来
人 民 铁 路 通 四 海	祖 国 资 源 利 八 方
文 明 行 车 争 先 进	礼 貌 服 务 似 亲 人
礼 让 三 先 为 人 为 己	平 安 一 路 利 国 利 家
礼 让 三 分 三 分 笑 脸 七 分 暖	情 牵 一 路 一 路 春 风 九 路 歌
飞 穿 平 原 芳 草 绿	奔 驰 山 野 落 花 红
平 地 四 轮 急 似 电	都 城 十 里 快 如 风
船 中 渡 日 月	水 上 看 风 光
巧 借 风 帆 力	端 赖 水 火 功
货 走 百 川 顺 利	船 行 千 里 安 全
几 经 风 雨 几 经 浪	一 路 平 安 一 路 歌
机 越 千 山 万 水	情 送 四 面 八 方
跃 上 高 空 程 万 里	迎 来 胜 友 客 千 家
澄 波 影 里 星 辰 动	明 月 船 中 诗 酒 歌
满 载 夕 阳 满 载 月	一 船 胜 友 一 船 歌
不 是 国 家 关 照 好	何 来 病 老 幸 福 多
岁 月 无 情 催 白 首	东 风 有 意 焕 青 春
彩 笔 传 情 歌 四 化	丹 霞 达 意 颂 长 征
长 征 踏 出 阳 关 道	四 化 绽 开 幸 福 花
春 风 南 国 来 新 燕	旭 日 东 方 起 大 鹏
春 风 终 解 千 层 雪	海 水 还 连 两 岸 心
光 荣 传 统 光 荣 史	英 雄 阵 地 英 雄 兵
五 洲 风 云 收 眼 底	万 家 苦 乐 在 心 头
兴 邦 有 策 儿 孙 福	报 国 无 私 赤 子 心
雄 关 似 铁 天 天 越	捷 报 如 潮 日 日 来
祖 国 山 河 无 限 好	人 民 天 下 万 年 青
民 拥 军 意 比 泰 山 重	军 爱 民 情 似 东 海 深
处 处 替 人 民 着 想	事 事 与 群 众 商 量
将 革 命 进 行 到 底	为 人 民 服 务 终 生
举 贤 任 能 兴 国 计	治 穷 致 富 利 民 生
加 强 法 制 万 民 同 乐	发 展 经 济 百 业 齐 兴
开 发 财 源 为 民 致 富	唯 才 是 举 替 国 进 贤
从 小 爱 科 学	长 大 攀 高 峰
进 门 都 是 客	到 此 即 为 家
居 安 来 客 喜	喜 客 来 安 居
莫 言 身 是 寄	能 使 客 如 归
地 角 天 涯 千 里 客	五 湖 四 海 一 家 亲
浮 生 若 寄 谁 非 梦	到 此 能 安 即 是 家
楼 外 楼 中 皆 暖 意	客 来 客 往 见 深 情
热 心 接 待 远 近 客	笑 迎 奉 送 异 乡 人
热 心 迎 来 三 江 客	笑 颜 送 去 四 海 宾
相 留 四 海 五 湖 客	尊 重 东 西 南 北 人
迎 八 面 春 风 入 院	接 四 方 宾 客 归 家
宾 到 如 归 声 声 笑 语	客 来 是 喜 面 面 春 风
小 住 为 佳 客 来 则 喜	引 人 入 胜 宾 至 如 归
春 夏 秋 冬 一 岁 川 流 不 息	东 西 南 北 四 方 宾 至 如 归
春 夏 秋 冬 一 载 川 流 不 息	东 南 西 北 四 方 宾 至 如 归
交 以 诚 接 以 礼 一 团 和 气	近 者 悦 远 者 来 四 海 春 风
以 天 下 为 己 任 红 心 似 火	将 宾 客 将 亲 人 笑 脸 如 春
情 深 似 海 国 际 友 好 织 彩 带	誉 重 如 山 民 间 往 来 架 金 桥
就 我 生 春 色	为 君 修 美 容
推 平 旧 世 界	亮 出 新 天 地
照 人 须 照 己	修 面 亦 修 身
不 教 白 发 催 人 老	更 喜 春 风 满 面 生
耳 中 为 送 消 息 好	面 上 应 无 毫 发 遗
善 心 不 欲 佳 人 老	巧 手 能 教 颜 面 新
士 行 端 宜 新 耳 目	人 情 原 贵 美 须 眉
喜 看 大 地 莺 歌 燕 舞	笑 迎 农 家 马 壮 牛 欢
腊 尽 春 归 山 村 添 喜 气	牛 肥 马 壮 门 户 浴 春 风
鼠 去 牛 来 一 元 欣 复 始	春 明 日 丽 万 象 喜 更 新
喜 鹊 登 梅 百 族 迎 佳 节	金 牛 献 瑞 万 里 笑 春 风
门 浴 春 风 梅 吐 艳	户 生 虎 气 鸟 争 鸣
牛 肥 马 壮 丰 收 岁	虎 跃 龙 腾 大 有 年
牛 肥 马 壮 家 家 富	虎 跃 龙 腾 处 处 春
牛 奋 四 蹄 开 锦 绣	虎 添 双 翼 会 风 云
人 逢 盛 世 精 神 壮	虎 跃 奇 峰 气 势 雄
人 间 喜 庆 康 平 世	虎 岁 承 欢 幸 福 春
人 入 虎 年 鼓 虎 劲	门 添 春 色 发 春 辉
人 添 志 气 虎 添 翼	雪 舞 丰 年 燕 舞 春
人 效 黄 牛 心 自 贵	岁 朝 寅 虎 劲 更 高
山 明 水 秀 风 光 丽	虎 跃 龙 腾 日 月 新
生 气 联 吟 欣 虎 虎	留 春 伴 读 奋 年 年
四 海 三 江 春 气 息	千 家 万 户 虎 精 神
四 海 笙 歌 迎 虎 岁	九 州 英 杰 跃 鹏 程
新 年 捷 报 虎 添 翼	大 路 朝 阳 马 奋 蹄
一 代 英 豪 生 虎 气	三 春 杨 柳 动 莺 歌
英 雄 时 代 英 雄 业	龙 虎 精 神 龙 虎 年
莺 歌 燕 舞 新 春 日	虎 跃 龙 腾 大 治 年
迎 春 节 莺 歌 遍 地	兴 中 华 虎 劲 冲 天
虎 跃 龙 腾 九 州 焕 彩	风 调 雨 顺 五 谷 丰 登
牛 奔 福 地 普 天 献 瑞	虎 卧 华 堂 满 院 生 辉
紫 气 东 来 江 山 如 画	红 旗 招 展 龙 虎 扬 威
祖 国 富 强 神 龙 活 虎	人 民 幸 福 舞 燕 飞 莺
白 虎 替 青 牛 招 财 进 宝	黄 莺 鸣 翠 柳 辞 旧 迎 新
虎 跃 龙 腾 创 人 间 奇 迹	莺 歌 燕 舞 描 大 地 春 光
虎 跃 龙 腾 有 天 皆 丽 日	花 香 鸟 语 无 地 不 春 风
岁 月 逢 春 山 河 添 锦 绣	人 民 思 治 龙 虎 振 精 神
效 虎 豪 吟 放 怀 歌 富 岁	闻 鸡 起 舞 挥 笔 颂 春 光
牛 年 虽 过 去 牛 劲 更 增 多 奉 献	虎 岁 喜 临 门 虎 威 大 振 有 精 神
虎 振 雄 风 留 浩 气	兔 迎 盛 世 启 新 程
金 杯 醉 酒 乾 坤 大	玉 兔 迎 春 岁 月 新
金 虎 腾 跃 风 流 世	玉 兔 笑 迎 锦 绣 春
庆 玉 兔 今 年 奋 起	祝 金 龙 明 岁 腾 飞
深 山 虎 啸 雄 风 在	绿 野 兔 奔 好 景 来
深 山 虎 啸 雄 风 在	绿 野 兔 奔 美 景 来
岁 首 喜 看 玉 兔 跃	耳 边 犹 有 金 龙 吟
兔 奔 千 里 传 春 信	龙 起 九 霄 壮 国 威
兔 镜 常 圆 人 盼 好	龙 甲 时 耀 国 期 安
兔 跃 千 山 传 喜 讯	龙 腾 万 里 展 英 才
喜 玉 兔 今 年 奋 起	祝 巨 龙 明 岁 腾 飞
艳 阳 高 照 门 庭 瑞	玉 兔 喜 临 世 纪 新
玉 兔 报 春 田 野 绿	金 鸡 唱 晓 艳 阳 红
玉 兔 呈 祥 家 家 乐	金 龙 兆 瑞 步 步 高
玉 兔 毫 光 生 紫 气	金 龙 捷 足 入 青 云
玉 兔 欢 奔 芳 草 地	金 乌 腾 跃 碧 云 天
春 回 大 地 百 花 吐 艳	兔 跃 青 山 万 物 生 辉
虎 啸 千 山 声 声 响 应	兔 驰 万 里 步 步 腾 飞
送 虎 岁 共 庆 山 河 壮	迎 兔 年 齐 歌 业 绩 新
北 斗 回 寅 万 户 金 鸡 争 唱 晓	东 风 送 暖 九 霄 玉 兔 喜 迎 春
虎 岁 三 十 爆 竹 声 声 辞 旧 岁	兔 年 初 一 红 联 对 对 迎 新 年
喜 今 朝 玉 兔 欢 跃 九 州 生 色	望 明 岁 金 龙 奋 起 万 里 腾 飞
爆 竹 庆 新 春 玉 兔 毫 光 生 紫 气	华 灯 辞 旧 岁 金 龙 捷 足 入 青 云
八 面 威 风 增 国 力	九 州 春 色 启 龙 年
北 海 云 生 龙 对 舞	丹 山 日 上 凤 双 飞
笔 走 神 龙 大 手 笔	春 归 盛 世 好 青 春
笔 走 神 龙 凭 大 手	诗 流 雅 韵 有 高 人
彩 凤 来 仪 迎 大 治	金 龙 起 舞 庆 新 春
苍 龙 日 暮 还 行 雨	老 树 春 深 更 著 花
辰 日 一 轮 驰 浩 宇	龙 年 百 业 壮 中 华
出 海 神 龙 开 世 纪	挥 毫 妙 笔 颂 春 秋
春 日 春 风 春 浩 荡	龙 年 龙 岁 龙 腾 飞
春 雨 多 情 绿 大 地	金 龙 展 志 壮 神 州
大 业 功 成 惊 世 界	巨 龙 飞 跃 盛 中 华
大 丈 夫 无 须 待 兔	有 志 者 必 定 腾 龙
丹 凤 朝 阳 歌 盛 世	苍 龙 布 雨 润 神 州
动 地 惊 天 龙 气 象	锦 山 绣 水 凤 文 章
风 发 龙 门 春 浪 暖	日 临 雁 塔 晓 云 开
风 来 松 度 龙 吟 曲	雨 过 庭 余 鸟 迹 书
改 革 迎 来 金 虎 啸	开 放 喜 看 玉 龙 腾
国 策 英 明 增 国 力	龙 年 飞 跃 展 龙 图
国 运 国 兴 凭 国 策	龙 飞 龙 跃 靠 龙 人
虎 跃 龙 腾 欢 盛 世	莺 歌 燕 舞 贺 新 春
花 柳 春 风 催 燕 舞	英 雄 祖 国 盼 龙 飞
华 堂 戏 燕 春 风 暖	盛 世 腾 龙 国 色 娇
黄 龙 行 雨 腾 沧 海	紫 凤 驾 云 上 碧 霄
江 山 故 国 堪 留 鹤	华 夏 高 天 可 腾 龙
金 龙 报 春 春 风 暖	铁 手 造 福 福 气 浓
金 龙 出 海 迎 新 岁	彩 凤 朝 阳 贺 小 康
金 龙 闹 海 春 潮 涌	喜 鹊 登 枝 福 韵 高
锦 绣 山 川 春 色 绣	奔 腾 江 海 巨 龙 腾
九 九 祥 云 舒 玉 兔	千 千 情 结 系 金 龙
九 州 丽 日 迎 新 纪	四 海 龙 吟 乐 大 年
龙 岁 迎 来 新 世 纪	莺 歌 唱 出 好 春 光
龙 腾 广 宇 添 新 秀	兔 丽 长 河 展 壮 图
龙 腾 虎 跃 春 光 好	鸟 语 花 香 世 纪 新
龙 腾 虎 跃 新 世 纪	年 富 力 强 好 时 光
龙 腾 虎 跃 兴 大 治	燕 舞 莺 歌 庆 升 平
龙 腾 盛 世 千 家 喜	春 满 神 州 万 物 荣
鼠 去 牛 来 欣 大 治	龙 腾 虎 跃 奋 新 程
蹄 奋 不 须 鞭 震 耳	牛 勤 何 用 用 当 头
土 生 白 玉 牛 羊 壮	地 产 黄 金 鸡 犬 欢
为 民 当 效 黄 牛 力	报 国 壮 怀 赤 子 心
五 岭 莺 歌 又 燕 舞	九 州 马 叫 并 牛 欢
新 春 乐 咏 黄 牛 颂	小 院 频 传 喜 鹊 歌
新 春 人 唱 黄 牛 赞	丰 岁 诗 吟 白 雪 歌
新 春 喜 作 黄 牛 颂	旭 日 高 悬 致 富 门
新 村 喜 盼 铁 牛 到	农 家 笑 望 春 燕 飞
有 福 人 家 牛 报 喜	无 边 春 色 燕 衔 来
玉 鼠 回 宫 传 捷 报	金 牛 奋 地 涌 春 潮
猪 肥 牛 壮 家 家 乐	燕 舞 莺 歌 处 处 春
龙 腾 霄 汉 开 新 运	鹊 立 枝 头 报 好 音
龙 腾 新 纪 百 年 好	马 跃 长 征 万 里 遥
龙 腾 云 海 国 昌 盛	春 满 人 间 民 泰 安
龙 兴 阳 动 乾 坤 晓	政 协 人 和 天 地 春
龙 种 自 与 常 人 殊	鹏 鸟 岂 堪 同 日 语
梅 花 香 遍 神 州 地	龙 步 震 开 盛 纪 春
梅 为 春 意 赋 新 意	雪 向 龙 年 报 丰 年
梅 为 小 院 添 春 色	鹊 向 龙 年 报 好 音
门 对 龙 山 门 进 宝	户 栽 花 树 户 生 辉
民 情 雀 跃 符 民 意	国 步 龙 腾 壮 国 威
明 山 卧 虎 吉 祥 地	丽 水 腾 龙 锦 绣 程
鸟 鸣 春 日 惊 山 水	鱼 跃 龙 门 动 地 天
七 五 征 程 如 奔 兔	三 中 伟 业 胜 腾 龙
千 家 福 气 金 龙 降	万 里 春 光 紫 燕 衔
千 里 云 霞 辉 大 地	万 般 气 象 壮 龙 年
千 秋 事 业 神 龙 舞	一 代 风 流 骏 马 驰
人 心 思 治 江 山 固	国 步 腾 龙 世 纪 新
人 心 向 党 人 承 福	国 步 腾 龙 国 更 强
如 意 春 风 催 虎 啸	吉 祥 云 彩 壮 龙 腾
瑞 霭 满 堂 年 喜 庆	神 龙 闹 海 世 清 明
诗 画 满 园 铺 锦 绣	风 雷 动 地 走 龙 蛇
世 纪 春 光 辉 大 地	江 山 国 色 舞 神 龙
世 纪 风 云 龙 际 会	春 风 杨 柳 燕 剪 裁
四 化 征 途 加 马 力	三 阳 开 泰 颂 龙 年
天 地 神 龙 开 盛 纪	人 间 紫 燕 舞 新 春
兔 辞 胜 岁 传 佳 话	龙 奋 新 程 建 大 功
兔 年 捷 报 惊 世 界	龙 岁 雄 风 震 乾 坤
兔 随 冬 去 留 春 意	龙 伴 春 来 壮 画 图
万 水 千 山 凭 虎 跃	五 湖 四 海 任 龙 腾
万 物 呈 祥 荣 盛 世	九 龙 献 瑞 庆 良 辰
唯 大 英 雄 能 伏 虎	是 真 豪 杰 乃 降 龙
无 边 春 色 来 天 地	有 志 金 龙 越 古 今
昔 年 虎 啸 千 山 壮	今 日 龙 腾 四 海 春
喜 报 人 间 曾 伏 虎	新 开 世 纪 正 腾 龙
喜 看 龙 年 花 千 树	笑 饮 改 革 酒 一 杯
喜 庆 爆 竹 送 玉 兔	吉 祥 梅 花 迎 金 龙
欣 看 大 地 千 重 秀	笑 望 巨 龙 四 海 飞
幸 福 家 庭 龙 虎 卧	文 明 宅 第 子 孙 贤
学 海 潮 头 龙 影 动	书 山 路 上 凤 声 高
燕 舞 莺 歌 相 比 美	龙 腾 虎 跃 竞 争 先
一 片 惊 涛 龙 出 海	八 方 锦 绣 燕 衔 春
一 元 复 始 龙 增 岁	万 物 生 辉 燕 报 春
莺 歌 燕 舞 春 光 美	虎 跃 龙 腾 国 事 兴
迎 龙 年 唯 求 国 利	喜 新 政 只 为 宜 民
鱼 跃 龙 门 千 业 振	民 奔 富 路 万 家 欢
玉 兔 呈 祥 留 硕 绩	金 龙 献 瑞 创 辉 煌
玉 兔 辞 年 传 吉 利	金 龙 贺 岁 保 平 安
玉 兔 回 宫 攀 月 桂	金 龙 浴 日 上 云 霄
云 灵 化 鹤 人 增 寿	海 啸 腾 龙 国 有 威
云 龙 上 下 驰 东 野	雪 鹤 飞 扬 入 北 山
中 华 民 族 龙 传 世	百 鸟 成 群 凤 向 阳
中 华 跃 日 神 龙 舞	大 地 迎 春 紫 燕 飞
中 华 振 兴 巨 龙 舞	大 地 焕 然 万 象 新
装 点 江 山 凭 妙 手	更 新 世 纪 在 龙 年
紫 燕 庭 前 传 吉 语	金 龙 户 外 报 佳 音
锦 绣 前 程 龙 腾 虎 跃	辉 煌 胜 纪 燕 舞 莺 歌
龙 上 高 天 凤 翔 过 树	春 盈 大 地 花 漫 神 州
龙 腾 云 海 凤 翔 天 宇	春 满 江 山 花 漫 神 州
兔 腾 大 地 清 辉 万 里	龙 舞 长 空 捷 报 千 传
虎 跃 龙 腾 建 功 九 万 里	莺 歌 燕 舞 造 福 两 千 年
喜 气 满 庭 阶 春 来 福 地	凯 歌 传 江 海 鱼 跃 龙 门
大 开 大 放 虎 跃 龙 腾 奔 四 化	双 节 双 增 莺 歌 燕 舞 入 三 春
兔 卧 蓝 田 万 里 春 风 舒 碧 野	龙 腾 玉 宇 千 家 笑 语 乐 新 程
兔 走 乌 飞 大 舞 兔 毫 辞 兔 岁	龙 腾 虎 跃 敢 攀 龙 角 接 龙 年
绣 水 描 山 神 州 大 地 春 常 在	藏 龙 卧 虎 盛 世 人 家 福 永 存
爆 竹 辞 旧 岁 玉 兔 毫 光 生 紫 气	华 灯 照 新 春 金 龙 捷 足 步 青 云
海 是 龙 故 乡 龙 腾 海 宇 龙 光 起	春 为 燕 天 地 燕 舞 春 风 燕 语 新
海 是 龙 故 乡 龙 腾 海 宇 龙 兴 起	春 为 花 世 界 花 吐 春 光 花 盛 开
虎 跃 龙 腾 万 里 长 征 风 光 无 限	花 香 鸟 语 九 州 大 地 春 色 正 浓
笔 走 龙 蛇 资 雅 韵	诗 题 福 寿 贺 新 春
辰 龙 回 宫 欣 报 捷	巳 蛇 出 洞 喜 迎 新
城 乡 改 革 龙 蛇 舞	梅 柳 争 春 世 纪 新
出 常 山 而 雄 岁 月	腾 大 泽 以 壮 神 州
春 风 送 暖 蛇 年 好	瑞 气 盈 门 鹊 语 香
大 治 山 河 铺 锦 绣	小 龙 日 月 更 辉 煌
丰 年 盛 景 龙 蛇 舞	新 岁 春 光 彩 蝶 飞
丰 岁 龙 腾 盈 喜 气	新 年 蛇 跃 涌 春 潮
风 光 无 限 蛇 开 泰	事 业 有 为 国 展 姿
风 华 正 茂 青 春 美	蛇 岁 呈 欢 世 纪 新
庚 辰 胜 岁 堂 堂 去	辛 巳 芳 春 鼎 鼎 来
金 龙 含 珠 辞 旧 岁	银 蛇 吐 宝 贺 新 春
金 山 水 漫 双 蛇 舞	绿 野 春 归 百 鸟 鸣
金 蛇 狂 舞 丰 收 岁	玉 燕 喜 迎 幸 福 春
金 蛇 狂 舞 迎 春 曲	丹 凤 朝 阳 纳 吉 图
金 蛇 披 彩 新 春 到	喜 鹊 登 梅 幸 福 来
灵 蛇 出 洞 吐 春 意	喜 鹊 登 梅 报 福 音
灵 蛇 飞 舞 千 山 秀	神 骏 奔 腾 九 野 新
灵 蛇 起 舞 迎 新 纪	快 马 加 鞭 奔 富 途
龙 归 碧 海 波 涛 舞	蛇 到 青 山 草 木 新
龙 年 共 庆 辉 煌 日	蛇 岁 同 奔 锦 绣 程
龙 蛇 共 舞 三 春 景	鸾 凤 齐 鸣 四 海 祥
龙 岁 才 舒 千 里 目	蛇 年 更 上 一 层 楼
龙 岁 才 舒 千 里 目	巳 年 更 上 一 层 楼
龙 岁 已 开 新 世 纪	蛇 年 又 展 好 春 光
龙 腾 大 地 春 阳 丽	蛇 舞 神 州 胜 纪 新
龙 腾 广 宇 江 山 丽	蛇 舞 神 州 岁 月 新
龙 腾 盛 世 千 年 瑞	蛇 舞 神 州 万 代 荣
龙 腾 四 海 家 家 乐	蛇 舞 九 州 处 处 新
龙 腾 宇 际 春 烂 漫	蛇 步 锦 程 业 辉 煌
龙 戏 宝 珠 辞 旧 岁	蛇 衔 瑞 草 贺 新 春
龙 戏 高 天 鱼 戏 水	蛇 游 大 泽 燕 游 春
龙 兴 大 业 开 新 纪	蛇 舞 阳 春 奏 凯 歌
绿 水 欢 歌 歌 盛 纪	银 蛇 起 舞 舞 新 春
人 怀 壮 志 江 山 秀	蛇 报 新 春 世 纪 新
人 民 有 福 歌 新 政	祖 国 长 春 舞 小 龙
山 高 水 远 人 增 志	蛇 接 龙 年 地 满 春
山 欢 水 笑 普 天 乐	龙 去 蛇 来 遍 地 春
山 蛇 起 舞 云 行 雨	喜 鹊 争 鸣 雪 点 梅
蛇 年 四 季 百 花 艳	燕 影 千 家 五 谷 丰
蛇 年 喜 庆 丰 收 景	燕 语 欢 歌 幸 福 家
蛇 吐 宝 珠 辞 旧 岁	燕 衔 柳 叶 贺 新 春
蛇 吐 宝 珠 辞 旧 岁	龙 含 瑞 气 贺 新 春
世 纪 更 新 人 不 老	灵 芝 献 寿 蛇 迎 春
世 纪 神 州 添 锦 绣	蛇 年 伟 业 更 辉 煌
寿 比 青 松 福 比 海	蛇 盘 玉 兔 鹊 盘 梅
岁 辞 大 泽 春 风 劲	人 舞 小 龙 世 纪 新
天 蓝 水 碧 青 蛇 降	柳 绿 桃 红 紫 燕 飞
天 增 岁 月 开 新 纪	春 满 乾 坤 舞 小 龙
天 征 瑞 象 迎 新 岁	山 舞 银 蛇 庆 早 春
喜 鹊 高 歌 传 捷 报	金 蛇 狂 舞 庆 丰 年
小 龙 起 舞 神 州 地	祖 国 腾 飞 大 治 年
辛 夜 平 安 开 景 远	巳 年 大 吉 启 新 程
新 春 喜 鹊 登 枝 唱	吉 地 银 蛇 降 福 来
银 花 火 树 新 春 夜	丹 凤 金 蛇 大 治 年
银 蛇 漫 舞 千 家 乐	紫 燕 欢 歌 万 里 春
云 霞 燕 舞 春 光 艳	灵 草 蛇 衔 寿 气 浓
龙 腾 碧 海 人 间 改 岁	蛇 舞 青 山 大 地 皆 春
龙 归 大 海 滚 滚 春 潮 逐 浪 起	蛇 舞 青 云 浓 浓 喜 气 盈 门 来
龙 舞 雪 花 四 野 寒 风 随 雪 尽	蛇 衔 春 色 九 天 暖 意 逐 春 回
蛇 至 龙 回 重 开 新 岁 人 间 景	山 欢 水 笑 又 度 佳 节 天 下 春
四 海 龙 腾 盈 门 喜 气 临 春 到	九 州 蛇 舞 满 面 春 风 报 喜 来
玉 燕 翻 飞 千 秋 大 业 千 秋 世	金 蛇 狂 舞 万 里 春 风 万 里 歌
八 骏 风 驰 千 里 近	一 年 花 发 十 分 红
白 马 壮 心 奔 大 道	青 春 浩 气 献 中 华
百 花 齐 放 春 光 好	万 马 奔 腾 国 步 雄
百 花 齐 放 春 光 好	万 马 奔 腾 气 象 新
爆 竹 声 声 催 快 马	梅 花 朵 朵 笑 春 风
奔 腾 骏 马 驰 大 道	浩 荡 春 风 遍 神 州
车 水 马 龙 农 家 乐	花 香 鸟 语 大 地 春
车 水 马 龙 一 路 景	花 香 鸟 语 万 家 春
春 风 得 意 人 得 志	骏 马 扬 蹄 国 扬 威
春 风 送 暖 花 千 树	骏 马 扬 蹄 路 万 程
春 风 万 里 辞 蛇 岁	笑 语 千 家 入 马 年
春 风 笑 逐 福 音 至	天 马 喜 随 捷 报 飞
春 花 吐 艳 香 千 里	快 马 加 鞭 跃 九 州
春 江 花 月 宜 人 景	龙 马 海 风 强 国 图
辞 年 喜 饮 三 蛇 酒	贺 岁 争 描 八 骏 图
大 道 扬 鞭 驰 骏 马	高 天 阔 地 展 雄 才
大 路 长 征 驰 骏 马	中 华 伟 业 展 雄 才
大 鹏 欢 喜 天 空 阔	骏 马 何 愁 道 路 长
得 意 春 风 催 骏 马	及 时 惠 雨 润 鲜 花
东 方 古 国 红 旗 舞	大 路 长 征 骏 马 驰
冬 去 蛇 留 诗 意 里	春 来 马 入 画 图 中
冬 去 蛇 留 诗 意 美	春 来 马 跃 画 图 新
福 到 门 庭 梅 吐 艳	马 驰 道 路 柳 生 烟
高 天 雪 舞 银 蛇 去	大 地 春 归 骏 马 来
好 借 春 风 酬 壮 志	快 催 骏 马 跃 前 程
好 凭 妙 手 书 鹏 赋	当 显 雄 才 唱 大 风
红 旗 辉 映 神 州 地	骏 马 喜 迎 大 治 年
红 旗 招 展 九 州 画	骏 马 奔 腾 万 里 春
化 雨 携 来 龙 露 贵	踏 花 归 去 马 蹄 香
江 涛 气 势 风 雷 动	龙 马 精 神 世 纪 兴
捷 报 随 雪 飞 梅 上	蹄 花 染 香 到 春 头
金 蛇 狂 舞 九 州 景	骏 马 欢 腾 四 海 春
金 蛇 起 舞 颂 功 去	骏 马 奔 腾 报 捷 来
金 蛇 喜 舞 九 州 富	骏 马 欢 腾 四 海 春
九 天 日 暖 张 鹏 翼	四 野 春 新 逐 马 蹄
举 红 旗 旗 开 得 胜	乘 骏 马 马 到 成 功
骏 马 奔 腾 春 色 丽	艳 阳 照 耀 岁 华 新
骏 马 奔 腾 千 里 路	新 春 更 上 一 层 楼
骏 马 奋 蹄 千 里 路	大 鹏 舒 翼 九 重 天
快 马 加 鞭 争 朝 夕	壮 志 凌 云 写 春 秋
龙 马 精 神 壮 四 海	风 云 气 象 会 三 春
绿 水 青 山 迎 宝 马	红 梅 白 雪 送 灵 蛇
春 到 人 间 新 燕 舞	喜 盈 门 第 铁 牛 忙
春 临 门 户 白 雪 化	福 降 人 间 黄 牛 忙
辞 旧 迎 新 除 硕 鼠	富 民 强 国 效 勤 牛
翠 柳 迎 春 千 里 绿	黄 牛 耕 地 万 山 金
耕 者 有 牛 皆 种 地	神 州 无 处 不 欢 歌
红 梅 傲 雪 千 门 福	碧 野 放 牛 五 谷 丰
金 牛 开 出 丰 收 景	喜 鹊 衔 来 幸 福 春
绿 柳 摇 风 燕 织 锦	红 桃 沐 雨 牛 耕 春
年 丰 人 寿 家 家 乐	春 到 花 开 处 处 耕
牛 奔 马 跃 行 千 里	凤 舞 龙 飞 上 九 霄
牛 年 喜 奏 丰 年 乐	人 世 笑 迎 盛 世 春
牛 主 乾 坤 春 浩 荡	人 逢 喜 庆 气 昂 扬
人 寿 年 丰 农 家 乐	地 肥 水 美 春 牛 歌
人 物 风 流 心 向 党	黄 牛 勤 奋 力 耕 田
神 州 无 处 不 放 彩	农 户 有 牛 喜 迎 春
鼠 报 平 安 归 玉 宇	牛 随 吉 瑞 下 天 庭
鼠 去 牛 来 辞 旧 岁	龙 飞 凤 舞 庆 新 春
马 奔 大 道 风 生 响	春 到 农 家 雪 吐 香
马 步 青 云 迎 旭 日	羊 腾 绿 野 展 雄 风
梅 花 欢 喜 漫 天 雪	骏 马 奔 驰 一 路 春
门 前 春 色 迎 人 笑	路 上 蹄 花 映 眼 新
鹏 举 长 空 九 万 里	马 驰 盛 纪 二 千 年
旗 展 五 星 四 海 笑	马 奔 万 里 九 州 春
千 帆 竞 渡 千 重 浪	万 马 奔 腾 万 里 春
千 里 江 山 春 气 象	一 年 锦 绣 马 风 光
庆 佳 节 九 州 同 乐	贺 新 春 万 马 奔 腾
人 得 春 风 牛 得 草	国 扬 威 力 马 扬 蹄
人 欢 马 叫 升 平 世	燕 语 莺 歌 锦 绣 春
瑞 霭 盈 门 春 在 户	红 旗 引 路 马 扬 蹄
三 春 芳 讯 传 莺 口	万 里 东 风 逐 马 蹄
色 借 梅 花 香 借 雪	壮 观 骏 马 美 观 春
山 舞 银 蛇 梅 吐 艳	原 驰 骏 马 草 含 春
十 分 春 色 辉 天 地	万 马 蹄 花 入 画 图
十 里 早 莺 鸣 暖 树	一 群 骏 马 跃 雄 关
世 纪 春 风 吹 绿 野	中 华 神 马 啸 新 程
腾 飞 骏 马 奔 千 里	改 革 春 风 暖 万 家
天 高 碧 宇 随 鹏 举	路 远 轻 风 任 马 驰
天 马 行 空 迎 盛 纪	黄 莺 戏 柳 报 新 春
万 里 清 风 舒 画 卷	一 鞭 神 骏 奋 前 程
万 里 征 途 千 里 马	十 年 树 木 百 年 人
万 马 奔 腾 五 彩 路	百 花 齐 放 四 时 春
万 马 千 军 创 大 业	五 湖 四 海 涌 春 潮
文 明 盛 世 飞 春 色	锦 绣 前 程 亮 马 蹄
无 边 春 色 百 花 艳	有 庆 年 头 万 马 驰
无 须 添 足 蛇 归 洞	不 待 扬 鞭 马 奋 蹄
向 阳 花 木 三 春 秀	得 意 马 蹄 一 路 风
新 岁 更 腾 千 里 马	壮 心 高 展 九 霄 鹏
一 代 英 豪 图 伟 业	九 州 骏 马 踏 雄 风
一 路 马 蹄 花 引 蝶	万 家 春 色 柳 闻 莺
英 才 竞 献 兴 邦 策	骏 马 齐 奔 强 国 途
英 雄 骏 马 奔 千 里	浩 荡 春 风 暖 万 家
莺 歌 柳 浪 千 家 笑	马 踏 春 风 一 路 花
莺 歌 杨 柳 枝 枝 秀	马 跃 前 程 步 步 高
迎 春 策 马 声 威 壮	破 浪 扬 帆 气 势 雄
映 日 红 霞 浮 白 马	宜 人 春 色 到 农 家
跃 马 乘 风 奔 大 道	腾 龙 出 海 振 神 州
跃 马 日 行 九 万 里	腾 龙 历 展 二 千 年
张 灯 结 彩 迎 春 节	跃 马 扬 鞭 步 小 康
政 策 归 心 人 振 奋	春 风 得 意 马 腾 飞
壮 志 凌 云 振 鹏 翼	扬 鞭 催 马 奔 征 程
春 风 得 意 马 驰 千 里	旭 日 扬 辉 光 照 万 家
大 海 方 平 千 帆 竞 发	征 途 正 远 万 马 奔 腾
好 雨 知 时 百 花 齐 放	春 风 得 意 万 马 奔 腾
快 马 加 鞭 振 兴 祖 国	闻 鸡 起 舞 建 设 家 园
鸟 语 花 香 满 园 春 色	人 欢 马 叫 一 路 凯 歌
山 舞 银 蛇 春 光 烂 漫	原 驰 骏 马 节 日 欢 腾
喜 盈 门 天 乐 人 亦 乐	春 及 第 马 驰 志 也 驰
一 夜 报 春 百 花 齐 放	三 阳 开 道 万 马 奔 腾
月 圆 花 好 鸟 飞 鱼 跃	雨 顺 风 调 马 壮 人 欢
百 花 争 艳 祖 国 春 光 好	万 马 奔 腾 改 革 事 业 兴
快 马 舞 东 风 春 盈 四 海	梅 花 香 大 地 喜 满 九 州
马 壮 牛 肥 山 村 添 喜 气	地 灵 人 杰 门 户 沐 春 风
鸟 语 花 香 九 州 春 光 好	人 欢 马 叫 四 季 画 图 新
奇 迹 不 奇 英 雄 能 创 造	远 征 非 远 良 马 自 奋 蹄
五 谷 丰 登 银 蛇 载 誉 去	百 花 争 艳 金 马 踏 春 来
喜 四 化 征 途 莺 歌 燕 舞	看 九 州 大 地 马 叫 人 欢
策 马 争 春 马 跃 马 年 加 马 力	驾 龙 追 日 龙 腾 龙 国 振 龙 威
大 地 回 春 锦 绣 河 山 添 异 彩	征 途 跃 马 英 雄 儿 女 着 先 鞭
改 革 开 放 神 州 巨 变 真 无 比	奋 发 图 强 骏 马 奔 腾 大 有 为
花 红 柳 绿 河 山 壮 丽 门 庭 秀	民 富 国 强 龙 马 奔 腾 世 纪 新
继 往 开 来 世 纪 春 光 无 限 好	承 前 启 后 神 州 骏 马 有 奔 头
千 帆 竞 发 几 经 风 雨 几 经 浪	万 马 奔 腾 一 路 凯 歌 一 路 春
小 龙 辞 岁 好 凭 妙 手 书 鹏 赋	骏 马 迎 春 当 显 雄 才 唱 大 风
银 蛇 归 去 盛 赞 人 间 春 色 美	金 马 奔 来 争 夸 祖 国 气 象 新
春 风 会 马 年 一 路 凯 歌 迎 盛 世	九 霄 鹏 鹏 举 九 霄 九 霄 飞 捷 报
千 里 马 马 奔 千 里 千 里 荡 春 风	骏 马 早 迎 春 一 代 英 豪 图 改 革
黄 莺 初 唱 晓 千 里 乐 声 唱 丰 收	看 旧 岁 银 蛇 起 舞 群 山 增 秀 色
大 地 迎 马 年 一 路 凯 歌 壮 春 风	万 里 蓝 天 莺 歌 燕 舞 春 光 无 限
宝 马 腾 飞 迎 福 至	灵 羊 起 舞 报 春 来
才 听 骏 马 踏 花 去	又 见 金 羊 献 瑞 来
草 肥 水 甜 牛 羊 壮	人 杰 地 灵 五 谷 香
长 空 载 誉 夸 天 马	大 地 回 春 颂 吉 羊
春 满 神 州 舒 画 卷	羊 临 华 夏 入 诗 篇
得 意 春 风 催 快 马	解 人 新 岁 献 灵 羊
得 意 春 风 扬 马 首	宜 人 景 色 赖 羊 毫
好 鸟 鸣 春 歌 盛 世	吉 羊 启 运 乐 升 平
画 展 春 城 描 特 色	诗 题 羊 石 纪 新 春
金 凤 呈 祥 人 得 意	玉 羊 衔 瑞 事 称 心
金 马 奔 驰 改 革 路	银 羊 欢 跃 太 平 年
九 州 百 族 辞 马 岁	两 岸 三 通 接 羊 年
骏 马 功 成 领 功 去	吉 羊 捷 足 报 捷 来
灵 羊 捷 足 登 新 境	骏 马 奋 蹄 向 未 来
马 步 生 风 辞 旧 岁	羊 毫 挥 墨 写 佳 联
马 驰 碧 野 凯 歌 壮	羊 跃 青 山 景 色 新
马 驰 大 道 征 途 远	羊 上 奇 峰 景 色 娇
马 驰 万 里 传 捷 报	羊 越 千 山 奏 凯 歌
马 驰 原 野 繁 花 茂	羊 跃 神 州 事 业 兴
马 年 事 事 如 人 意	羊 岁 时 时 报 福 音
马 岁 事 事 合 民 意	羊 年 处 处 沐 春 风
人 怀 远 志 驰 良 马	世 易 新 春 唤 白 羊
神 马 行 空 普 天 瑞	仙 羊 下 界 遍 地 春
世 纪 更 新 花 吐 艳	春 风 送 暖 瑞 呈 祥
誓 做 长 征 千 里 马	争 当 改 革 领 头 羊
岁 焕 新 风 燕 剪 柳	春 来 大 地 羊 铺 云
天 涯 芳 草 绿 马 蹄	华 夏 玉 羊 欢 羊 毫
万 树 争 荣 添 翠 色	五 羊 献 瑞 报 佳 音
万 象 更 新 新 世 纪	五 羊 献 瑞 瑞 门 庭
万 象 已 随 新 律 转	五 羊 争 跃 好 春 来
五 羊 献 瑞 人 增 寿	百 鸟 鸣 春 喜 盈 门
五 羊 献 瑞 增 春 色	百 鸟 争 鸣 唱 福 音
喜 得 马 年 成 骏 业	笑 看 羊 岁 展 鸿 图
喜 看 阳 春 花 千 树	笑 饮 新 岁 酒 一 杯
羊 角 扶 摇 九 万 里	马 蹄 奔 向 二 千 年
羊 年 喜 千 家 祝 福	国 运 昌 万 物 生 春
玉 羊 启 泰 迎 春 至	金 马 奋 蹄 载 誉 归
玉 宇 澄 清 观 燕 舞	草 原 茂 盛 喜 羊 欢
送 马 年 春 花 融 白 雪	迎 羊 岁 喜 鹊 闹 红 梅
万 象 更 新 山 青 水 秀	五 羊 献 瑞 日 丽 春 华
艳 阳 高 照 江 山 添 锦 绣	壮 志 常 存 祖 国 更 富 强
骏 马 奔 驰 满 载 乌 金 辞 岁 去	吉 羊 起 舞 豪 吟 白 雪 报 春 来
骏 马 荣 归 一 路 梅 花 频 送 笑	吉 羊 欢 驾 九 州 绿 草 快 铺 春
马 去 蹄 香 北 国 又 添 千 里 马	羊 来 春 暖 南 疆 再 现 五 仙 羊
猴 去 鸡 来 胜 利 年	莺 歌 燕 舞 腾 飞 岁
猴 喜 满 园 桃 李 艳	岁 迁 遍 地 春 光 明
金 猴 献 瑞 财 源 广	紫 燕 迎 春 生 意 隆
金 猴 玉 兔 弄 春 色	紫 燕 黄 莺 弹 妙 音
雪 消 门 外 千 山 绿	猴 到 人 间 万 户 春
终 迎 胜 利 猴 年 赞	席 再 腾 飞 世 人 歌
金 猴 献 礼 家 家 顺 利	喜 鹊 闹 春 事 事 吉 祥
除 夕 猴 在 山 重 享 齐 天 乐	迎 春 鸡 报 晓 高 唱 东 方 红
猴 岁 呈 祥 长 空 五 光 十 色	鸡 年 纳 福 大 地 万 紫 千 红
大 业 方 兴 五 星 旗 展 金 鸡 唱	小 康 在 望 四 化 图 开 彩 凤 飞
鸡 唱 三 通 万 家 春 正 乾 坤 气	凤 鸣 两 岸 一 树 梅 开 天 地 心
金 鸡 报 晓 改 革 似 春 风 化 雨	彩 凤 朝 阳 腾 飞 如 旭 日 升 华
雄 鸡 唱 韵 万 户 桃 符 新 气 象	大 地 回 春 群 山 霞 彩 富 神 州
紫 燕 迎 春 一 路 东 风 歌 大 治	金 鸡 唱 晓 九 州 时 雨 润 小 康
春 回 大 地 喜 庆 新 春 闻 鸡 起 舞	福 满 人 间 欣 逢 盛 世 跃 马 扬 鞭
辞 旧 灵 鸡 歌 日 丽	迎 新 瑞 犬 报 年 丰
鸡 年 利 事 家 家 乐	犬 岁 发 财 户 户 欢
鸡 去 瑶 池 传 喜 讯	犬 来 大 地 报 春 意
鸡 声 笛 韵 祥 云 灿	犬 迹 梅 花 瑞 雪 飞
鸡 岁 已 添 几 多 喜	犬 年 更 上 一 层 楼
鸡 为 岁 归 留 竹 叶	犬 因 春 到 献 梅 花
犬 效 丰 年 家 家 富	鸡 鸣 盛 世 处 处 春
春 风 又 绿 江 南 岸	好 雨 复 滋 甲 子 年
花 香 鸟 语 山 村 好	雨 顺 风 调 鼠 岁 丰
火 树 银 花 迎 玉 鼠	山 珍 海 味 列 金 盘
甲 第 连 云 欣 发 展	子 年 遍 地 祝 丰 收
甲 子 迎 春 多 瑞 霭	文 明 建 国 遍 春 风
九 州 浪 潮 逐 鼠 去	万 里 东 风 吹 富 来
灵 鼠 迎 春 春 色 好	金 鸡 报 晓 晓 光 新
绿 酒 添 香 甲 子 岁	雪 花 献 瑞 大 丰 年
十 二 时 辰 鼠 在 首	一 年 四 季 春 为 头
万 千 气 象 开 新 景	一 代 风 流 壮 鼠 年
银 花 火 树 迎 金 鼠	海 味 山 珍 列 玉 盘
子 年 大 有 山 河 壮	甲 岁 丰 盈 日 月 新
子 时 一 到 开 新 律	鼠 岁 三 春 报 好 音
子 岁 人 奔 新 富 路	甲 年 众 改 旧 乾 坤
雪 花 献 瑞 玉 龙 飞 起 三 百 万	绿 酒 添 欢 金 鼠 报 来 十 二 时
爆 竹 欣 祝 福	银 蛇 喜 迎 春
晴 点 龙 飞 去	珠 还 蛇 舞 来
金 蛇 狂 舞 春 添 彩	玉 树 临 风 喜 满 门
龙 飞 蛇 舞 升 平 岁	燕 语 莺 歌 盛 世 春
龙 含 宝 珠 辞 旧 岁	蛇 吐 瑞 气 贺 新 春
龙 腾 祥 云 门 接 福	蛇 吐 瑞 气 户 迎 春
龙 吟 碧 落 存 余 韵	蛇 舞 神 州 唱 大 风
巳 岁 迎 春 花 开 早	蛇 年 纳 福 喜 报 多
祥 龙 兆 祥 蛇 兆 福	喜 鹊 报 喜 梅 报 春
爆 竹 声 声 龙 吟 随 腊 去	欢 歌 阵 阵 蛇 舞 伴 春 来
春 明 花 艳 民 富 国 强	春 燕 剪 梅 喜 鹊 登 春
满 园 春 色 一 团 和 气	梅 传 春 讯 雪 兆 丰 年
全 家 福 气 满 院 春 光	鹊 传 喜 讯 风 送 佳 音
群 芳 斗 艳 百 业 争 荣	人 歌 四 化 鸟 唱 三 春
瑞 雪 辞 岁 腊 梅 迎 春	三 春 放 彩 五 福 生 根
山 河 永 固 大 地 同 春	山 河 壮 丽 日 月 光 华
树 承 雨 露 花 沐 春 光	鹊 送 喜 报 鸡 传 佳 音
百 事 可 乐 万 象 更 新	百 顺 为 福 六 合 同 春
春 风 及 第 瑞 霭 盈 门	春 光 满 室 瑞 气 盈 门
九 州 日 丽 四 化 春 新	梅 开 佳 景 雪 兆 丰 年
梅 映 红 日 雪 兆 丰 年	门 迎 百 福 户 纳 千 祥
人 增 寿 纪 天 转 阳 和	三 山 生 色 五 湖 呈 祥
岁 当 盛 世 人 逢 华 年	岁 丰 人 寿 春 和 景 明
百 族 共 乐 两 岸 同 春	春 风 送 暖 政 策 归 心
家 和 业 旺 国 泰 民 安	江 山 若 画 岁 月 如 歌
红 楼 旭 日 绿 柳 芳 春	红 梅 吐 蕊 绿 竹 催 春
花 开 富 贵 竹 报 平 安	花 香 四 季 月 满 一 轮
九 州 国 泰 六 合 春 新	腊 梅 报 喜 飞 雪 迎 春
龙 兴 华 夏 燕 舞 阳 春	龙 吟 国 瑞 虎 啸 年 丰
年 丰 人 寿 景 泰 春 和	年 年 如 意 处 处 春 风
牛 耕 绿 野 虎 啸 青 山	千 峰 月 色 五 湖 春 光
时 和 景 奉 雪 瑞 花 奇	岁 且 更 始 时 乃 日 新
新 年 初 气 古 国 雄 风	新 岁 献 瑞 腊 梅 迎 春
一 声 爆 响 万 里 春 回	鱼 游 深 水 鸟 占 高 枝
安 定 团 结 人 心 所 向	正 本 清 源 国 运 必 兴
百 年 大 计 树 人 为 本	万 里 长 征 立 志 当 先
百 花 争 艳 神 州 莺 歌 燕 舞	大 地 生 辉 祖 国 桃 红 柳 绿
百 鸟 鸣 春 堪 喜 人 间 换 岁	群 龙 献 瑞 欣 逢 世 纪 更 新
百 业 方 兴 到 处 五 光 十 色	九 州 全 盛 应 时 万 紫 千 红
爆 竹 声 声 喜 报 前 程 锦 绣	梅 花 朵 朵 欢 呼 万 象 更 新
爆 竹 声 中 听 到 隆 隆 战 鼓	梅 花 香 里 迎 来 滚 滚 春 潮
爆 竹 迎 春 春 丽 五 湖 四 海	红 梅 报 喜 喜 催 万 马 千 军
才 过 小 龙 年 又 催 千 里 马	曾 经 大 风 浪 更 上 一 层 楼
彩 笔 如 花 写 就 辉 煌 事 业	春 风 似 剪 裁 成 锦 绣 江 山
彩 笔 如 花 写 就 辉 煌 岁 月	春 风 似 剪 裁 成 锦 绣 江 山
春 风 吹 春 雨 洒 百 花 齐 放	党 纪 严 党 风 正 万 事 皆 通
春 风 催 旧 岁 华 夏 百 花 艳	瑞 雪 兆 丰 年 神 州 万 象 新
春 光 好 春 意 浓 春 华 秋 实	民 族 兴 民 心 顺 民 富 国 强
春 回 大 地 处 处 花 明 柳 绿	福 至 人 间 家 家 语 笑 歌 欢
春 阳 送 暖 坚 持 中 国 特 色	东 风 化 雨 发 扬 民 主 精 神
辞 旧 岁 家 家 门 前 阳 光 道	迎 新 春 户 户 窗 外 幸 福 花
辞 旧 岁 祝 丰 年 神 州 共 庆	迎 新 春 歌 改 革 普 天 同 乐
大 厦 落 成 到 处 欢 天 喜 地	福 人 迁 入 满 堂 金 碧 辉 煌
发 扬 民 主 国 家 繁 荣 昌 盛	加 强 法 制 人 民 安 定 团 结
发 展 多 种 经 营 财 源 茂 盛	大 高 科 学 种 田 五 谷 丰 登
芳 草 先 知 喜 报 春 归 大 地	梅 花 初 吐 欣 观 绿 投 满 山
风 调 雨 顺 处 处 山 欢 水 笑	政 通 人 和 年 年 国 泰 民 安
福 星 照 吉 宅 新 春 家 家 乐	普 天 同 欢 度 神 州 处 处 春
改 革 开 红 花 呈 中 国 特 色	小 康 铺 富 路 通 人 间 天 堂
改 革 鲜 花 开 遍 三 山 五 岳	文 明 硕 果 结 满 万 户 干 家
甘 露 无 声 绣 出 千 红 万 紫	阳 春 有 脚 送 来 十 雨 五 风
鼓 雄 风 再 展 中 华 昌 盛 景	树 壮 志 开 创 神 州 富 贵 天
国 兴 旺 家 兴 旺 国 家 兴 旺	老 平 安 少 平 安 老 少 平 安
红 日 无 私 温 暖 五 湖 四 海	春 风 有 情 染 绿 万 水 千 山
虎 跃 龙 腾 碧 海 黄 山 玉 宇	莺 歌 燕 舞 春 风 旭 日 神 州
虎 跃 龙 腾 碧 水 苍 山 玉 宇	莺 歌 燕 舞 和 风 丽 日 神 州
惠 政 暖 民 心 乐 小 康 岁 月	春 风 融 国 土 壮 大 好 河 山
货 架 上 下 朵 朵 红 梅 争 艳	柜 台 内 外 张 张 笑 脸 迎 春
家 家 户 户 处 处 干 干 净 净	事 事 时 时 人 人 平 平 安 安
九 州 大 地 处 处 莺 歌 燕 舞	四 化 征 途 年 年 虎 跃 龙 腾
九 州 大 地 到 处 莺 歌 燕 舞	四 海 征 途 一 路 马 叫 人 欢
九 州 大 地 皆 春 春 风 惠 我	万 里 河 山 造 景 景 色 宜 人
军 爱 民 民 拥 军 情 同 手 足	民 养 军 军 护 民 亲 似 鱼 水
看 祖 国 红 旗 招 展 景 如 画	望 世 界 山 雨 欲 来 风 满 楼
来 于 民 养 于 民 用 之 于 民	安 于 军 施 于 军 赖 之 于 军
楼 高 厦 大 不 分 官 宅 民 宅	气 爽 风 清 但 见 梅 园 杏 园
门 户 放 开 引 进 新 鲜 空 气	国 家 改 革 迎 来 灿 烂 春 光
南 疆 雨 北 国 风 风 调 雨 顺	东 海 龙 西 山 凤 凤 舞 龙 飞
浓 墨 映 影 描 得 山 川 秀 色	巨 毫 生 辉 写 就 时 代 华 章
庆 佳 节 户 户 家 家 喜 事 多	迎 新 春 山 山 水 水 风 光 美
庆 胜 利 举 金 杯 春 满 万 户	贺 丰 收 展 笑 颜 喜 盈 千 家
人 寿 年 丰 生 活 越 来 越 好	风 和 日 雨 春 光 如 画 如 诗
人 寿 年 丰 生 活 越 来 越 好	莺 歌 燕 舞 春 光 如 画 如 诗
人 心 安 定 华 夏 千 山 竞 秀	国 运 昌 隆 神 州 万 木 争 荣
日 月 共 长 天 同 心 相 运 转	江 河 合 大 海 融 会 聚 波 平
入 龙 岁 人 人 壮 改 革 雄 心	迎 新 年 处 处 树 文 明 新 风
瑞 雪 飘 飘 喜 伴 神 州 美 景	腊 梅 朵 朵 笑 迎 华 夏 春 光
山 青 水 秀 映 改 革 千 秋 画	鸟 语 花 香 颂 文 明 万 代 歌
深 化 改 革 一 心 共 建 大 业	放 开 胆 子 举 国 同 奔 小 康
神 州 华 夏 不 可 分 离 两 地	炎 黄 子 孙 终 将 团 聚 一 堂
书 作 良 田 百 世 耕 之 不 尽	勤 为 至 宝 一 生 用 则 有 余
水 碧 映 山 青 青 山 映 碧 水	花 红 扶 叶 绿 绿 叶 扶 红 花
松 香 竹 香 梅 香 香 风 阵 阵	天 美 地 美 人 美 美 意 重 重
天 马 行 空 日 丽 风 和 雨 顺	灵 蛇 在 世 政 通 国 泰 民 安
听 遍 地 豪 歌 征 人 添 虎 劲	看 漫 天 彩 霞 战 马 长 精 神
万 众 一 心 创 造 锦 绣 乐 园	五 讲 四 美 建 设 精 神 文 明
文 明 经 商 货 流 五 湖 四 海	礼 貌 待 人 心 向 万 户 千 家
杏 雨 飞 红 喜 织 千 家 春 色	和 风 着 绿 巧 绣 万 里 新 图
雄 鸡 一 唱 扫 尽 残 星 晓 月	万 众 齐 欢 迎 来 化 雨 春 风
旭 日 腾 彩 霞 春 色 无 限 好	红 梅 傲 霜 雪 江 山 分 外 娇
旭 日 祥 云 灿 九 州 花 似 锦	春 风 化 雨 新 四 海 歌 如 潮
羊 笔 如 花 写 就 辉 煌 岁 月	春 风 似 剪 裁 成 锦 绣 江 山
羊 笔 生 花 喜 写 辉 煌 岁 月	春 风 似 剪 精 裁 锦 绣 山 河
莺 歌 燕 舞 笑 迎 神 州 巨 变	虎 跃 龙 腾 欢 建 华 夏 文 明
迎 新 年 满 园 春 色 满 园 锦	辞 旧 岁 遍 地 鲜 花 遍 地 歌
迎 新 年 三 江 春 水 三 江 洒	干 四 化 一 寸 光 阴 一 寸 金
中 华 三 度 腾 飞 全 民 共 庆	宇 内 千 般 改 革 万 物 皆 春
紫 燕 高 飞 剪 开 千 重 云 雾	布 谷 欢 歌 唤 起 万 家 春 耕
尊 师 重 教 四 海 群 芳 竞 秀	革 故 鼎 新 九 州 万 木 争 荣
百 花 争 艳 欣 望 江 山 千 里 秀	万 民 欢 庆 齐 颂 祖 国 万 年 春
百 花 竞 盛 开 日 月 同 辉 三 代 表	万 马 齐 飞 跃 城 乡 共 建 两 文 明
报 晓 鸡 声 拂 晓 钟 声 声 声 悦 耳	赏 心 国 事 舒 心 家 事 事 事 关 情
龙 携 华 夏 腾 飞 飞 起 玉 龙 三 百 万	蛇 伴 新 春 狂 舞 舞 来 银 蛇 数 千 条
山 新 水 美 万 户 千 家 都 夸 政 策 好	国 富 民 强 南 天 北 地 同 庆 丰 收 乐
修 道 修 仙 先 须 修 身 身 为 道 之 本	信 佛 学 佛 不 可 离 心 心 是 佛 之 源
祖 国 在 心 金 杯 在 手 张 张 笑 脸 迎 新 岁	春 光 入 眼 瑞 气 入 杯 处 处 欢 歌 颂 小 康
长 空 五 光 十 色 除 夕 猴 在 山 重 享 齐 天 乐	大 地 万 紫 千 红 迎 春 鸡 报 晓 高 唱 东 方 红
酒 绿 灯 红 今 夜 连 双 岁 愿 世 间 岁 岁 如 意	人 勤 春 早 明 朝 又 一 年 祝 天 下 年 年 称 心
忆 旧 岁 牛 劲 冲 霄 汉 神 鞭 一 指 神 州 巨 变	看 今 朝 虎 威 壮 中 华 众 志 成 城 经 济 腾 飞
著 手 成 春 多 凭 三 代 丰 功 百 年 史 迹 翻 新 叶	与 时 俱 进 满 载 九 州 生 气 万 马 蹄 声 起 壮 图
百 川 长 流 百 船 竞 发 观 八 方 佳 宾 心 满 意 足 五 湖 四 海 承 前 启 后	万 物 兴 盛 万 马 奔 驰 望 九 州 大 地 风 调 雨 顺 一 国 两 制 继 往 开 来
敢 争 日 月 开 新 纪	定 教 山 川 换 旧 颜
世 纪 祥 龙 添 百 福	新 年 好 景 纳 千 祥
四 海 歌 迎 新 世 纪	九 州 曲 奏 颂 升 平
四 化 美 景 诗 中 画	十 五 蓝 图 锦 上 花
兔 年 笔 发 花 娇 艳	龙 岁 图 新 伟 业 长
万 里 河 山 兴 特 色	九 州 儿 女 庆 团 圆
祖 国 万 方 传 喜 讯	神 舟 一 号 奏 强 音
送 五 福 春 燕 剪 柳	贺 三 捷 喜 鹊 登 梅
酒 热 诗 歌 壮	梅 红 天 地 新
风 和 日 暖 男 男 女 女 迎 春 节	大 地 春 回 万 里 河 山 呈 画 卷
圣 德 服 中 外 大 节 共 山 河 不 变	英 名 振 古 今 精 忠 同 日 月 常 明
笑 到 几 时 方 合 口	坐 来 无 日 不 开 怀
开 口 便 笑 笑 古 笑 今	大 度 能 容 忘 情 岁 月
白 雪 有 古 调	青 山 无 俗 缘
光 华 呈 爱 日	仁 寿 遍 和 风
画 情 八 窗 纳	春 意 百 花 舒
欢 心 依 日 永	乐 志 愿 春 和
吉 云 垂 大 地	慈 镜 昭 诸 天
看 花 生 意 蕊	听 雨 发 言 泉
流 水 如 有 意	高 云 共 此 心
梅 报 平 安 信	鸟 传 如 意 春
善 果 皆 欢 喜	香 云 普 吉 祥
闲 情 空 外 寄	妙 道 个 中 参
玉 堂 迎 燕 喜	云 鹤 有 奇 翼
具 神 通 力	生 欢 喜 心
流 水 今 日	明 月 前 身
芝 径 绕 而 曲	云 林 秀 以 直
宫 商 之 外 有 神 解	花 宫 俱 见 严 而 妙
鸟 吟 花 笑 有 余 乐	月 白 风 清 无 尽 藏
清 阳 欲 凌 霄 汉 上	远 意 自 在 山 水 间
胜 地 尚 传 诗 句 在	好 山 合 作 画 图 看
万 福 屏 中 春 永 茂	千 年 枝 上 日 重 光
相 于 明 月 清 风 际	只 在 高 山 流 水 间
烟 景 满 前 供 妙 墨	芳 洲 随 处 引 清 游
玉 箫 金 管 升 平 世	旭 日 和 风 瑞 应 图
宜 诗 宜 画 物 华 殊	雨 收 天 色 碧 于 蓝
不 到 长 城 非 好 汉	敢 教 日 月 换 新 天
钢 铁 长 城 千 载 固	辉 煌 大 业 万 年 兴
鱼 水 情 深 同 大 海	军 民 意 重 若 长 城
国 泰 民 安 千 秋 大 业 千 秋 颂	华 夏 龙 腾 长 城 内 外 皆 春 色
到 门 有 路 皆 环 水	是 屋 开 窗 便 见 山
亭 边 短 短 长 长 柳	渡 上 来 来 去 去 船
惟 有 艺 文 为 本 业	还 将 丹 青 传 雅 名
潮 声 只 向 雨 中 听	海 气 都 从 云 外 来
日 边 冲 要 无 双 地	天 下 繁 难 第 一 州
三 秀 草 盛 云 焕 彩	万 年 枝 茂 露 香 凝
自 有 山 川 开 北 极	天 然 风 景 胜 西 湖
万 里 长 城 穿 云 入 海 汉 代 江 山 留 胜 迹	千 秋 大 国 铁 壁 金 汤 秦 时 日 月 照 雄 关
把 酒 问 青 天	人 间 重 晚 晴
云 山 六 时 变	竹 风 醒 晚 醉
愿 大 地 都 成 净 土	问 众 生 谁 是 如 来
中 国 已 新 生	方 向 更 光 明
此 间 有 鸡 更 佳	做 事 要 大 家 来
常 德 德 山 山 有 德	长 沙 沙 水 水 无 沙
翻 经 留 作 将 来 眼	问 法 能 空 现 在 身
句 里 乾 坤 随 指 顾	斗 南 钟 鼓 闹 清 秋
三 江 风 雨 天 边 落	百 万 工 农 国 际 歌
四 面 云 山 都 到 眼	万 家 灯 火 最 关 心
五 六 月 间 无 暑 气	二 三 更 里 有 渔 歌
白 日 依 山 腾 紫 气	黄 河 入 海 涌 春 潮
当 头 华 岳 三 峰 出	迎 面 黄 河 九 曲 来
国 色 无 双 来 上 苑	无 香 岂 独 出 长 安
黄 河 九 曲 天 边 落	华 岳 三 峰 马 上 来
千 山 红 叶 千 山 树	万 里 黄 河 万 里 沙
万 里 黄 河 流 日 夜	中 州 文 物 壮 乾 坤
一 池 春 夏 秋 冬 水	满 苑 东 西 南 北 花
曾 经 沧 海 千 层 浪	又 上 黄 河 一 道 桥
凤 以 桐 为 宅	湖 光 穿 户 入
如 松 竹 之 茂	山 高 流 水 远
此 树 独 推 千 古 秀	名 花 常 占 四 时 春
看 看 世 事 摇 摇 手	想 想 人 情 点 点 头
碧 海 开 龙 藏	丹 青 山 外 寺
强 国 先 强 种	是 是 非 非 地
白 云 朝 夕 异	丹 青 山 外 寺
眼 中 沧 海 小	宅 入 先 贤 传
门 听 长 者 车	座 对 贤 人 酒
东 风 来 紫 气	大 地 发 春 辉
浪 击 龙 宫 鼓	强 国 先 强 种
心 生 大 欢 喜	佛 放 净 光 明
百 年 商 会 好 做 客	万 里 重 洋 频 引 资
海 纳 百 川 容 乃 大	陆 行 千 里 始 于 思
开 山 亭 接 星 辰 气	报 国 功 争 日 月 光
商 会 百 年 逢 盛 世	厦 门 今 日 沐 春 风
石 为 迎 宾 开 口 笑	山 能 作 主 乐 天 成
舒 怀 交 友 当 倾 美 酒	望 海 品 鲜 且 上 斯 楼
城 收 万 景 近	天 放 一 山 来
海 上 生 明 月	山 中 有 白 云
绿 树 多 生 意	白 云 无 尽 时
山 中 藏 古 寺	门 外 尽 劳 人
水 与 石 争 地	云 携 山 上 天
到 此 处 才 进 一 步	到 此 处 才 行 一 步
急 水 与 天 争 入 海	几 点 梅 花 归 笛 孔
绿 竹 青 松 一 径 雨	白 云 黄 叶 满 山 风
落 霞 半 分 酒 一 壶	桃 花 万 树 月 满 天
人 生 若 梦 谁 非 寄	到 处 能 安 即 是 家
上 方 月 出 初 生 白	下 界 尘 飞 不 染 红
文 如 大 历 十 才 子	园 在 将 军 第 五 桥
五 岭 北 来 山 到 地	九 州 南 尽 水 连 天
一 门 深 入 罗 浮 路	五 百 重 登 华 首 台
有 公 方 见 科 名 重	是 气 原 从 道 义 生
碧 野 田 间 牛 得 草	白 杨 林 里 马 识 途
书 山 有 路 勤 为 径	学 海 无 涯 苦 作 舟
治 学 当 思 日 精 进	为 官 应 效 清 正 廉
风 声 雨 声 读 书 声 声 声 入 耳	家 事 国 事 天 下 事 事 事 关 心
立 志 须 知 三 古 盛	为 书 自 起 一 家 言
吃 得 苦 中 苦	方 为 人 上 人
天 赋 诗 句 在 山 水	人 持 风 骨 见 笔 墨
境 由 心 造	事 在 人 为
读 经 读 史 读 遍 天 下 奇 书	修 行 修 德 修 成 世 上 俊 才
爱 我 中 华	安 定 团 结
安 居 乐 业	安 全 生 产
百 年 树 人	百 事 大 吉
百 业 兴 旺	柏 翠 梅 香
便 民 利 国	财 源 似 水
春 到 万 家	春 风 化 雨
千 车 连 万 户	一 线 贯 九 州
春 华 秋 实	春 回 华 夏
春 来 喜 气	春 联 祝 福
春 满 乾 坤	春 满 人 间
春 满 神 州	春 满 校 园
春 色 满 园	春 舒 锦 绣
恩 泽 千 秋	儿 童 乐 园
二 人 同 心	发 展 经 济
繁 荣 昌 盛	繁 荣 经 济
风 调 雨 顺	风 和 日 丽
服 务 人 民	福 地 洞 天
百 年 大 计 开 新 举	万 里 长 征 振 虎 风
福 积 泰 来	福 满 人 间
改 革 春 风 催 劲 羽	振 兴 喜 庆 鼓 鹏 程
国 富 民 强	国 泰 民 安
红 梅 报 喜	红 日 高 照
红 心 向 党	户 纳 千 祥
护 林 防 火	欢 度 春 节
积 德 人 家	吉 祥 如 意
桃 李 满 天 下	教 化 遍 中 华
吉 羊 迎 春	继 往 开 来
九 洲 桃 李 展 万 千 气 象	五 十 华 诞 庆 无 限 风 光
见 义 勇 为	建 功 立 业
建 设 祖 国	江 山 多 娇
江 山 锦 绣	教 育 有 方
金 融 实 体	经 济 繁 荣
九 州 春 浓	军 民 团 结
科 教 兴 农	克 己 奉 公
喜 今 朝 桃 芳 李 艳 频 让 三 秦 添 秀 色	待 明 日 俊 采 星 驰 再 为 华 夏 创 辉 煌
买 卖 公 平	满 面 春 风
满 市 春 色	满 院 生 辉
高 朋 满 座 款 款 真 情 歌 校 史	胜 友 如 云 浓 浓 厚 意 颂 华 诞
妙 手 回 春	民 富 国 强
民 生 在 勤	民 族 复 兴
纳 福 迎 祥	牛 肥 马 壮
普 天 同 庆	气 壮 山 河
前 程 似 锦	勤 俭 建 国
勤 劳 门 第	勤 政 为 民
清 正 廉 明	求 实 进 取
全 面 发 展	全 面 小 康
誉 满 三 秦 桃 李 花 盛 艳 华 夏	名 传 四 海 俊 才 辈 出 成 栋 梁
人 才 辈 出	人 定 胜 天
人 杰 地 灵	人 民 奋 发
人 心 思 治	日 新 月 异
荣 华 富 贵	三 十 而 立
三 元 及 第	深 化 改 革
生 财 有 道	生 意 兴 隆
春 风 化 雨 雨 露 滋 润 桃 李 满 天 下	名 校 育 人 人 才 辈 出 英 豪 遍 神 州
十 年 生 聚	时 和 岁 好
师 恩 浩 荡 不 忘 书 山 岁 月	学 情 深 长 永 怀 诗 海 年 华
实 事 求 是	四 海 升 平
四 海 同 春	四 季 长 春
四 季 呈 祥	四 季 平 安
四 时 如 意	四 世 同 堂
松 风 竹 韵	腾 飞 事 业
团 结 奋 斗	团 结 奋 进
万 事 如 意	万 象 更 新
为 国 争 光	为 民 造 福
文 化 园 林	文 明 经 商
青 春 有 志 须 勤 奋	学 业 启 门 报 苦 辛
文 明 商 城	五 福 临 门
五 谷 丰 登	五 世 其 昌
壮 志 凌 云 英 雄 奇 迹 惊 天 宇	凯 歌 动 地 时 代 新 潮 奏 乐 章
喜 气 盈 门	喜 庆 丰 年
喜 庆 羊 年	祥 云 北 至
花 献 革 新 者	功 昭 创 业 人
幸 福 人 家	养 车 致 富
一 尘 不 染	一 代 风 流
一 心 一 德	以 德 治 国
音 乐 茶 座	拥 军 爱 民
拥 政 爱 民	与 民 造 福
再 创 辉 煌	招 财 进 宝
政 策 归 心	政 通 人 和
祝 君 健 康	壮 志 凌 云
紫 气 东 来	自 力 更 生
尊 师 重 教	宾 至 如 归
清 心 提 神	四 季 飘 香
别 开 生 面	春 风 满 面
